    0         10        20        30        40        50        60        70        80        90        100       110       120       130       140       150       
    0123456789012345678901234567890123456789012345678901234567890123456789012345678901234567890123456789012345678901234567890123456789012345678901234567890123456789
0   ________________________________________________________________________________________________________________________________________________________________
1   ________________________________________________________________________________________________________________________________________________________________
2   ________________________________________________________________________________________________________________________________________________________________
3   ________________________________________________________________________________________________________________________________________________________________
4   ________________________________________________________________________________________________________________________________________________________________
5   ________________________________________________________________________________________________________________________________________________________________
6   ________________________________________________________________________________________________________________________________________________________________
7   ________________________________________________________________________________________________________________________________________________________________
8   ________________________________________________________________________________________________________________________________________________________________
9   ________________________________________________________________________________________________________________________________________________________________
10  ________________________________________________________________________________________________________________________________________________________________
11  ________________________________________________________________________________________________________________________________________________________________
12  ________________________________________________________________________________________________________________________________________________________________
13  ________________________________________________________________________________________________________________________________________________________________
14  ________________________________________________________________________________________________________________________________________________________________
15  ________________________________________________________________________________________________________________________________________________________________
16  ________________________________________________________________________________________________________________________________________________________________
17  ________________________________________________________________________________________________________________________________________________________________
18  ________________________________________________________________________________________________________________________________________________________________
19  ________________________________________________________________________________________________________________________________________________________________
20  ________________________________________________________________________________________________________________________________________________________________
21  ________________________________________________________________________________________________________________________________________________________________
22  ________________________________________________________________________________________________________________________________________________________________
23  ________________________________________________________________________________________________________________________________________________________________
24  ________________________________________________________________________________________________________________________________________________________________
25  ________________________________________________________________________________________________________________________________________________________________
26  ________________________________________________________________________________________________________________________________________________________________
27  ________________________________________________________________________________________________________________________________________________________________
28  ________________________________________________________________________________________________________________________________________________________________
29  ________________________________________________________________________________________________________________________________________________________________
30  ________________________________________________________________________________________________________________________________________________________________
31  ________________________________________________________________________________________________________________________________________________________________
32  ________________________________________________________________________________________________________________________________________________________________
33  ________________________________________________________________________________________________________________________________________________________________
34  ________________________________________________________________________________________________________________________________________________________________
35  ___________________________________________________________________________________________________________________________________________________________33333
36  _________________________________________________________________________________________________________________________________________________________3333333
37  ______________________________________________________________________________________________________________________________________________________3333333333
38  ____________________________________________________________________________________________________________________________________________________333333333333
39  __________________________________________________________________________________________________________________________________________________33333333333333
40  ________________________________________________________________________________________________________________________________________________3333333333333333
41  ______________________________________________________________________________________________________________________________________________333333333333333333
42  _____________________________________________________________________________________________________________________________________________3333333333333333333
43  ___________________________________________________________________________________________________________________________________________333333333333333333333
44  __________________________________________________________________________________________________________________________________________3333333333333333333333
45  _________________________________________________________________________________________________________________________________________33333333333333333333333
46  ________________________________________________________________________________________________________________________________________333333333333333333333333
47  _______________________________________________________________________________________________________________________________________3333333333333333333333333
48  ______________________________________________________________________________________________________________________________________33333333333333333333333333
49  ______________________________________________________________________________________________________________________________________33333333333333333333333333
50  _____________________________________________________________________________________________________________________________________333333333333333333333333333
51  _____________________________________________________________________________________________________________________________________333333333333333333333333333
52  ____________________________________________________________________________________________________________________________________3333333333333333333333333333
53  ____________________________________________________________________________________________________________________________________3333333333333333333333333333
54  ___________________________________________________________________________________________________________________________________33333333333333333333333333333
55  ____________________________________________________________________________________________________________________________________3333333333333333333333333333
56  ____________________________________________________________________________________________________________________________________3333333333333333333333333333
57  _____________________________________________________________________________________________________________________________________333333333333333333333333333
58  _____________________________________________________________________________________________________________________________________333333333333333333333333333
59  ______________________________________________________________________________________________________________________________________33333333333333333333333333
60  __________________________________________________________________________________________________________111111111111111111111111____33333333333333333333333333
61  _________________________________________________________________________________________________________1_______________________1____33333333333333333333333333
62  _________________________________________________________________________________________________________1_______________________1_____3333333333333333333333333
63  _________________________________________________________________________________________________________1_________________1111111_____3333333333333333333333333
64  _________________________________________________________________________________________________________111111111111111111____________3333333333333333333333333
65  ________________________________________________________________________________________________________________________________________333333333333333333333333
66  __________________________________________________________________________________________________________________________________________3333333333333333333333
67  ____________________________________________________________________________________________________________________________________________33333333333333333333
68  _____________________________________________________________________________________________________________________________________________3333333333333333333
69  ______________________________________________________________________________________________________________________________________________333333333333333333
70  ______________________________________________________________________________________________________________________________________________333333333333333333
71  _______________________________________________________________________________________________________________________________________________33333333333333333
72  _________________________________________________________________________________________________________________________________________________333333333333333
73  ____________________________________________________________________________________________________________________________________________________333333333333
74  _______________________________________________________________________________________________________________________________________________________333333333
75  _________________________________________________________________________________________________________________________________________________________3333333
76  ____________________________________________________________________________________________________________________________________________________________3333
77  ________________________________________________________________________________________________________________________________________________________________
78  ________________________________________________________________________________________________________________________________________________________________
79  ________________________________________________________________________________________________________________________________________________________________
80  ________________________________________________________________________________________________________________________________________________________________
81  ________________________________________________________________________________________________________________________________________________________________
82  ________________________________________________________________________________________________________________________________________________________________
83  ________________________________________________________________________________________________________________________________________________________________
84  _________________________________________________________________________________________________________________11111111111_11_________________________________
85  _________________________________________________________________________________________________________________1______1_____1_____________________________333_
86  ________________________________________________________________________________________________________________1_______1_____133________________3____333333333_
87  ________________________________________________________________________________________________________________1________1____133333_________3333_3333333333333_
88  ________________________________________________________________________________________________________________11_______1____1333333333___333333_3333333333333_
89  __________________________________________________________________________________________________________________111_____1___13333333333333333__33333333333333_
90  _____________________________________________________________________________________________________________________1_____1__1_3333333333333__3333333333333333_
91  ______________________________________________________________________________________________________________________1____1___1_33333333____333333333333333333_
92  _______________________________________________________________________________________________________________________1____1___1___33___3333333333333333333333_
93  _______________________________________________________________________________________________________________________1____1____1____3333333333333333333333333_
94  ________________________________________________________________________________________________________________________1____1____1___3333333333333333333333333_
95  _________________________________________________________________________________________________________________________1____1____1__3333333333333333333333333_
96  ___________________________________________________111111_________________________________111_____________________________1___1_____1__333333333333333333333333_
97  ___________________________________________________1____1_____________________________1111___11____________________________1___1_____1_333333333333333333333333_
98  ___________________________________________________1____1___________________________11___11____1____________________________1___1____1_333333__3333333333333333_
99  ___________________________________________________11__11_________________________331______11___11__________________________1___1____1_33333___3333333333333333_
100 _____________________________________________________11_________________________33331________1____1__________________________1___1___1_33333____333333333333333_
101 _____________________________________________________________________________33333331_________1____1__________________________1__1___1_3333_____333333333333333_
102 ___________________________________________________________________________3333333331_________1____1___________________________1__1__1_3333_____333333333333333_
103 _________________________________________________________________________333333333331__________1____1__________________________1__1__1_3333______33333333333333_
104 _3______________________________________________________________________3333333333331111111111__1___1__________________________1__1__1_333111111133333333333333_
105 _33___________________________________________________________________3333333333333_1______3__1__1___1_________________________1___1__13331_____133333333333333_
106 _3333________________________________________________________________333333333333__333__33_333_1_1___1__________________________1__1___1331____3133333333333333_
107 _33333333________333_______________________________________________33333333333___33333333333333_1_1___1_________________________1__1___133111111133333333333333_
108 _333333333333333333333__________________________________________33333333333___33333333333333333_1__1__1_________________________1__1____13333333333333333333333_
109 _33333333333333333333333333____3333333333333333______________3333333333____33333333333333333333331__1_1_________________________1__1_____1333333333333333333333_
110 _333333333333333333333333333333333333333333333333_________33333333_____33333333333333333333333333_1_1__1________________________1___1____1333333333333333333333_
111 _33333333333333333333333333333333333333333333333333333333333333___333333333333333333333333333333___1_1_1________________________1___1____1333333333333333333333_
112 _3333333333333333333333333333333333333333333333333333333333____3333333333333333333333333333333333__1_1_1________________________1___1____1333333333333333333333_
113 _3333333333333333333333333333333333333333333_______________33333333333333333333333333333333333333__1__1_1________________________1__1____1333333333333333333333_
114 _3333333333333333333333333333333333333333___333333333333333333333333333333333333333333333333333333__1_1_1________________________1__1____1_33333333333333333333_
115 _333333333333333333333333333333333333____333333333333333333333333333333333333333333333333333333333331_1_1________________________1___1___1___333333333333333333_
116 _333333333333333333333333333333______33333333333333333333333333333333333333333333333333333333333333_1__11________________________1___1___1____33333333333333333_
117 _33333333333333333333333333____33333333333333333333333333333333333333333333333333333333333333333333_1__1_1_______________________1___1____1_____333333333333333_
118 _333333333333333333333333__33333333333333333333333333333333333333333333333333333333333333333333333___1_1_1________________________1__1____1______33333333333333_
119 _3333333333333333333333__3333333333333333333333333333333333333333333333333333333333333333333333333___1__11________________________1__1____1_____133333333333333_
120 _333333333333333333____333333333333333333333333333333333333333333333333333333333333333333333333333___1__11________________________1__1____1_____133333333333333_
121 _333333333333______3333333333333333333333333333333333333333333333333333333333333333333333333333333___1__11________________________1___1___1_____133333333333333_
122 _____________33333333333333333333333333333333333333333333333333333333333333333333333333333333333333__1__1_1_______________________1___1____1____133333333333333_
123 _33333333333333333333333333333333333333333333333333333333333333333333333333333333333333333333333333___1_1_1_______________________1___1____1____133333333333333_
124 _3333333333333333333333333333333333333333333333333333333333333333333333333333333333333333333333333333_1_1_1________________________1__1____1_____11333333333333_
125 _3333333333333333333333333333333333333333333333333333333333333333333333333333333333333333333333333333_1__1_1_______________________1__1____1_____11333333333333_
126 _333333333333333333333333333333333________33333333333333333333333333333333333333333333333333333333333_1__1__1______________________1___1____1____11333333333333_
127 _333333333333333333333333333333333_________333333333__33333333333333333333333333333333333333333333333_1__1__1______________________1___1____1____11333333333333_
128 _333333333333333333333333333333333_________333333________33333333333333333333333333333333333333333333_1__1___1_____________________1___1____1____11_33333333333_
129 _33333333333333333333333333333333___________33333________113333333333333333333333333333333333333333___1__1____1____________________1___1____1____11____33333333_
130 _33333333333333333333333333333333___________3333_______11_11111111111133333333333333333333333333______1__1_____1___________________1___1____1____11_____________
131 _33333333333333333333333333333333____________333____111___1333333__331333333333333333333333333_11_11111__1_____1___________________1____1____1___11_____________
132 _33333333333333333333__3333333333____________33__111______133333_____13333333333333333333333__________1__1______1__________________1____1____1____1_____________
133 _3333333333333333333_____3333333______________311_________133333_____133333333333333333333_____________1__1_____1__________________1____1____1___11_____________
134 _3333333333333333333_______33333____________111___________13333______13333333333333333333______________1__1_____1__________________1____1____1____1_____________
135 _333333333333333333__________333_________111____________3_1333_______1333333333333333333________________1_1__1111___________________1___1____1____1_____________
136 _333333333333333333__________333_______11_______________33133________1333333333333333333_________________1111________________________1___1____1___1_____________
137 _33333333333333333___________333____111________________333133________133333333333333333______________________________________________1___1____1___1_____________
138 _33333333333333333____________3__111___________________333133________13333333333333333________________________________________________1111111111111_____________
139 _3333333333333333______________11_____________________3333133________1333333333333333___________________________________________________________________________
140 _3333333333333333___________111_______________________333313________1333333333333333____________________________________________________________________________
141 _3333333333333333________111_________________________3333313_______1333333333333333_____________________________________________________________________________
142 _3333333333333333____1111____________________________3333313______1333333333333333______________________________________________________________________________
143 _333333333333333__111_______________________111111_111111111111111333333333333333_______________________________________________________________________________
144 _33333333333333311_________________________1_______33333333333333333333333333333________________________________________________________________________________
145 _3333333333333331________________________11_______33333333333333333333333333333_________________________________________________________________________________
146 _3333333333333331_______________________1________33333333333333333333333333333_3________________________________________________________________________________
147 _3333333333333331______1111111111_____11________33333333333333333333333333333_33________________________________________________________________________________
148 _333333333333333_111111__________11111_________333333333333333333333333333333_33________________________________________________________________________________
149 _3333333333333________________________________333333333333333333333333333333_333________________________________________________________________________________
150 _33333333333_______________________________3_333333333333333333333333333333_333_________________________________________________________________________________
151 _333333333_______________________________33__33333333333333333333333333333_3333_________________________________________________________________________________
152 _33333__________________________________33__333333333333333333333333333333_3333_________________________________________________________________________________
153 _33____________________________________333__33333333333333333333333333333_33333_________________________________________________________________________________
154 ______________________________________333__33333333333333333333333333333_33333__________________________________________________________________________________
155 _____________________________________333_3_33333333333333333333333333333_33333__________________________________________________________________________________
156 ____________________________________333_3_33333333333333333333333333333_33333___________________________________________________________________________________
157 ____________________________________33_33_33333333333333333333333333333_33333___________________________________________________________________________________
158 ___________________________________33_33_33333333333333333333333333333_33333____________________________________________________________________________________
159 __________________________________333_33_33333333333333333333333333333_33333____________________________________________________________________________________
160 _________________________________333_33_333333333333333333333333333333_33333____________________________________________________________________________________
161 _______________________________3333_333_333333333333333333333333333333_3333_____________________________________________________________________________________
162 _____________________________33333_333_333333333333333333333333333333_33333_____________________________________________________________________________________
163 ___________________________333333_333_3333333333333333333333333333333_33333_____________________________________________________________________________________
164 _________________________3333333_333_33333333333333333333333333333333_33333_____________________________________________________________________________________
165 ________________________33333333_333_3333333333333333333333333333333_33333______________________________________________________________________________________
166 ______________________333333333_333_33333333333333333333333333333333_33333______________________________________________________________________________________
167 ________________________________________________________________________________________________________________________________________________________________
