    0         10        20        30        40        50        60        70        80        90        100       110       120       130       140       150       
    0123456789012345678901234567890123456789012345678901234567890123456789012345678901234567890123456789012345678901234567890123456789012345678901234567890123456789
0   ________________________________________________________________________________________________________________________________________________________________
1   ________________________________________________________________________________________________________________________________________________________________
2   ________________________________________________________________________________________________________________________________________________________________
3   ________________________________________________________________________________________________________________________________________________________________
4   ________________________________________________________________________________________________________________________________________________________________
5   ________________________________________________________________________________________________________________________________________________________________
6   ________________________________________________________________________________________________________________________________________________________________
7   ________________________________________________________________________________________________________________________________________________________________
8   ________________________________________________________________________________________________________________________________________________________________
9   ________________________________________________________________________________________________________________________________________________________________
10  ________________________________________________________________________________________________________________________________________________________________
11  ________________________________________________________________________________________________________________________________________________________________
12  ________________________________________________________________________________________________________________________________________________________________
13  ________________________________________________________________________________________________________________________________________________________________
14  ________________________________________________________________________________________________________________________________________________________________
15  ________________________________________________________________________________________________________________________________________________________________
16  ________________________________________________________________________________________________________________________________________________________________
17  ________________________________________________________________________________________________________________________________________________________________
18  ________________________________________________________________________________________________________________________________________________________________
19  _____________________________________________11111___11111___11111______________________________________________________________________________________________
20  _____________________________________________1___1___1___1___1___1______________________________________________________________________________________________
21  _____________________________________________1___1___1___1___1___1___11111___1___1______________________________________________________________________________
22  _____________________________________________1___1___1___1___1___1___1___1___1___1______________________________________________________________________________
23  ___________________________________________1_1___1___1___1___1___1___1___1___1___1______________________________________________________________________________
24  ___________________________________________1_1___1___1___1___1___1___1___1___1___1______________________________________________________________________________
25  ___________________________________________1_1___1___1___1___1___1___1___1___1___1______________________________________________________________________________
26  ___________________________________________1_1___1___1___1___1___1___1___1___1___1______________________________________________________________________________
27  ___________________________________________1_1___1___1___1___1___1___1___1___1___1______________________________________________________________________________
28  ___________________________________________1_1___1___1___1___1___1___1___1___1___1______________________________________________________________________________
29  ___________________________________________1_1___1___1___1___1___1___1___1___1___1______________________________________________________________________________
30  ___________________________________________1_1___1___1___1___1___1___1___1___1___1______________________________________________________________________________
31  ___________________________________________1_1___1___1___1___1___1___1___1___1___1______________________________________________________________________________
32  ___________________________________________1_1___1___1___1___1___1___1___1___1___1______________________________________________________________________________
33  ___________________________________________1_1___1___1___1___1___1___1___1___1___1______________________________________________________________________________
34  ___________________________________________1_1___1___1___1___1___1___1___1___1___1______________________________________________________________________________
35  ___________________________________________1_1___1___1___1___1___1___1___1___1___1______________________________________________________________________________
36  ___________________________________________1_1___1___1___1___1___1___1___1___1___1______________________________________________________________________________
37  ___________________________________________1_1___1___1___1___1___1___1___1___1___1______________________________________________________________________________
38  ___________________________________________1_1___1___1___1___1___1___1___1___1___1______________________________________________________________________________
39  ___________________________________________1_1___1___1___1___1___1___1___1___1___1______________________________________________________________________________
40  ___________________________________________1_1___1___1___1___1___1___1___1___1___1______________________________________________________________________________
41  ___________________________________________1_1___1___1___1___1___1___1___1___1___1______________________________________________________________________________
42  ___________________________________________1111111111111111111___1___1___111111111______________________________________________________________________________
43  _________________________________________________________1111111111111111111____________________________________________________________________________________
44  ________________________________________________________________________________________________________________________________________________________________
45  ________________________________________________________________________________________________________________________________________________________________
46  ________________________________________________________________________________________________________________________________________________________________
47  ________________________________________________________________________________________________________________________________________________________________
48  ________________________________________________________________________________________________________________________________________________________________
49  ________________________________________________________________________________________________________________________________________________________________
50  ________________________________________________________________________________________________________________________________________________________________
51  ________________________________________________________________________________________________________________________________________________________________
52  ________________________________________________________________________________________________________________________________________________________________
53  ________________________________________________________________________________________________________________________________________________________________
54  ________________________________________________________________________________________________________________________________________________________________
55  ________________________________________________________________________________________________________________________________________________________________
56  ___________________________________________________________________________________1111111111111111111111111111111111111111111111111111111111111111111111111111_
57  __________________________________________________________________________________1__1_1________________________________________________________________________
58  _________________________________________________________________________________1__1___________________________________________________________________________
59  ________________________________________________________________________________1__1_1______1111111111111111111111111111111111111111111111111111111111111111111_
60  _______________________________________________________________________________1__1__1_____1____________________________________________________________________
61  _______________________________________________________________________________1__1_1_____1_____________________________________________________________________
62  ______________________________________________________________________________1__1_1_____1______________________________________________________________________
63  _____________________________________________________________________________1__1_1______1______________________________________________________________________
64  ____________________________________________________________________________1__1_1______1_______________________________________________________________________
65  ___________________________________________________________________________1__1_1______1________________________________________________________________________
66  __________________________________________________________________________1__1_1______1_________________________________________________________________________
67  _________________________________________________________________________1__1__1_____1__________________________________________________________________________
68  ________________________________________________________________________1__1__1_____1___________________________________________________________________________
69  _______________________________________________________________________1__1__1______1___________________________________________________________________________
70  ______________________________________________________________________1__1__1______1____________________________________________________________________________
71  ______________________________________________________________________1__1_1______1_____________________________________________________________________________
72  _____________________________________________________________________1__1_1______1______________________________________________________________________________
73  ____________________________________________________________________1__1_1______1_______________________________________________________________________________
74  ___________________________________________________________________1__1__1_____1________________________________________________________________________________
75  __________________________________________________________________1_11__1______1________________________________________________________________________________
76  ________________________________________________________________1111___1______1_________________________________________________________________________________
77  ____________________________________________________________1111______1______1__________________________________________________________________________________
78  __________________________________________________________11_________1______1___________________________________________________________________________________
79  _________________________________________________________1__________1______1____________________________________________________________________________________
80  _________________________________________________________1__________1_____1_____________________________________________________________________________________
81  _______________________________________________________11__________1______1_____________________________________________________________________________________
82  ____________________________________________________111__1________1______1______________________________________________________________________________________
83  _____________________________________________1111111______1______1______1_______________________________________________________________________________________
84  _____________________________________________1____________1_____1______1________________________________________________________________________________________
85  _____________________________________________1_____________1___1______1_________________________________________________________________________________________
86  _____________________________________________1___________1111_1______1__________________________________________________________________________________________
87  _____________________________________________1___11111111_____1______1__________________________________________________________________________________________
88  _____________________________________________1111____________1______1___________________________________________________________________________________________
89  ____________________________________________11______________1______1____________________________________________________________________________________________
90  ____________________________________________1______________1______1_____________________________________________________________________________________________
91  ___________________________________________1______________1______1______________________________________________________________________________________________
92  ____________________________________________11___________1______1_______________________________________________________________________________________________
93  ______________________________________________11________1_______1_______________________________________________________________________________________________
94  ________________________________________________1_______1______1________________________________________________________________________________________________
95  _________________________________________________11____1______1_________________________________________________________________________________________________
96  ________________________________________________1__1__1______1__________________________________________________________________________________________________
97  _______________________________________________1__1__1______1___________________________________________________________________________________________________
98  ______________________________________________1__1__1______1____________________________________________________________________________________________________
99  _____________________________________________1__1__1_______1____________________________________________________________________________________________________
100 _____________________________________________1__1_1_______1_____________________________________________________________________________________________________
101 ____________________________________________1__1__1______1______________________________________________________________________________________________________
102 ___________________________________________1__1__1______1_______________________________________________________________________________________________________
103 __________________________________________1__1__1______1________________________________________________________________________________________________________
104 _________________________________________1__1__1______1_________________________________________________________________________________________________________
105 ________________________________________1__1__1_______1_________________________________________________________________________________________________________
106 _______________________________________1___1_1_______1__________________________________________________________________________________________________________
107 ______________________________________1___1_1_______1___________________________________________________________________________________________________________
108 _____________________________________1___1__1______1____________________________________________________________________________________________________________
109 _____________________________________1__1__1______1_____________________________________________________________________________________________________________
110 ____________________________________1__1__1______1______________________________________________________________________________________________________________
111 ___________________________________1__1__1_______1______________________________________________________________________________________________________________
112 __________________________________1___1_1_______1_______________________________________________________________________________________________________________
113 _________________________________1___1_1_______1________________________________________________________________________________________________________________
114 ________________________________1___1__1______1_________________________________________________________________________________________________________________
115 _______________________________1___1__1______1__________________________________________________________________________________________________________________
116 ______________________________1___1__1______1___________________________________________________________________________________________________________________
117 _____________________________1___1__1_______1___________________________________________________________________________________________________________________
118 _____________________________1__1__1_______1____________________________________________________________________________________________________________________
119 ____________________________1___1_1_______1_____________________________________________________________________________________________________________________
120 ___________________________1___1_1_______1______________________________________________________________________________________________________________________
121 __________________________1___1__1______1_______________________________________________________________________________________________________________________
122 _________________________1___1__1______1________________________________________________________________________________________________________________________
123 ________________________1___1__1_______1________________________________________________________________________________________________________________________
124 ________________________1__1__1_______1_________________________________________________________________________________________________________________________
125 ________________________1__1_1_______1__________________________________________________________________________________________________________________________
126 ________________________1_1_1_______1___________________________________________________________________________________________________________________________
127 ________________________11_1_______1____________________________________________________________________________________________________________________________
128 ________________________1__1______1_____________________________________________________________________________________________________________________________
129 _______________________11_1_______1_____________________________________________________________________________________________________________________________
130 _______________________111_______1______________________________________________________________________________________________________________________________
131 _______________________1111111111_______________________________________________________________________________________________________________________________
132 ________________________________________________________________________________________________________________________________________________________________
133 ________________________________________________________________________________________________________________________________________________________________
134 ________________________________________________________________________________________________________________________________________________________________
135 ________________________________________________________________________________________________________________________________________________________________
136 ________________________________________________________________________________________________________________________________________________________________
137 ________________________________________________________________________________________________________________________________________________________________
138 ________________________________________________________________________________________________________________________________________________________________
139 ________________________________________________________________________________________________________________________________________________________________
140 ________________________________________________________________________________________________________________________________________________________________
141 ________________________________________________________________________________________________________________________________________________________________
142 ________________________________________________________________________________________________________________________________________________________________
143 ________________________________________________________________________________________________________________________________________________________________
144 ________________________________________________________________________________________________________________________________________________________________
145 ________________________________________________________________________________________________________________________________________________________________
146 ________________________________________________________________________________________________________________________________________________________________
147 ________________________________________________________________________________________________________________________________________________________________
148 ________________________________________________________________________________________________________________________________________________________________
149 ________________________________________________________________________________________________________________________________________________________________
150 ________________________________________________________________________________________________________________________________________________________________
151 ________________________________________________________________________________________________________________________________________________________________
152 ________________________________________________________________________________________________________________________________________________________________
153 ________________________________________________________________________________________________________________________________________________________________
154 ________________________________________________________________________________________________________________________________________________________________
155 ________________________________________________________________________________________________________________________________________________________________
156 ________________________________________________________________________________________________________________________________________________________________
157 ________________________________________________________________________________________________________________________________________________________________
158 ________________________________________________________________________________________________________________________________________________________________
159 ________________________________________________________________________________________________________________________________________________________________
160 ________________________________________________________________________________________________________________________________________________________________
161 ________________________________________________________________________________________________________________________________________________________________
162 ________________________________________________________________________________________________________________________________________________________________
163 ________________________________________________________________________________________________________________________________________________________________
164 ________________________________________________________________________________________________________________________________________________________________
165 ________________________________________________________________________________________________________________________________________________________________
166 ________________________________________________________________________________________________________________________________________________________________
167 ________________________________________________________________________________________________________________________________________________________________
