    0         10        20        30        40        50        60        70        80        90        100       110       120       130       140       150       
    0123456789012345678901234567890123456789012345678901234567890123456789012345678901234567890123456789012345678901234567890123456789012345678901234567890123456789
0   ________________________________________________________________________________________________________________________________________________________________
1   ________________________________________________________________________________________________________________________________________________________________
2   ________________________________________________________________________________________________________________________________________________________________
3   ________________________________________________________________________________________________________________________________________________________________
4   ________________________________________________________________________________________________________________________________________________________________
5   ________________________________________________________________________________________________________________________________________________________________
6   ________________________________________________________________________________________________________________________________________________________________
7   ________________________________________________________________________________________________________________________________________________________________
8   ________________________________________________________________________________________________________________________________________________________________
9   ________________________________________________________________________________________________________________________________________________________________
10  ________________________________________________________________________________________________________________________________________________________________
11  ________________________________________________________________________________________________________________________________________________________________
12  ________________________________________________________________________________________________________________________________________________________________
13  ________________________________________________________________________________________________________________________________________________________________
14  ________________________________________________________________________________________________________________________________________________________________
15  ________________________________________________________________________________________________________________________________________________________________
16  ________________________________________________________________________________________________________________________________________________________________
17  ________________________________________________________________________________________________________________________________________________________________
18  ________________________________________________________________________________________________________________________________________________________________
19  ________________________________________________________________________________________________________________________________________________________________
20  ________________________________________________________________________________________________________________________________________________________________
21  ________________________________________________________________________________________________________________________________________________________________
22  ________________________________________________________________________________________________________________________________________________________________
23  ________________________________________________________________________________________________________________________________________________________________
24  ________________________________________________________________________________________________________________________________________________________________
25  ________________________________________________________________________________________________________________________________________________________________
26  ________________________________________________________________________________________________________________________________________________________________
27  ________________________________________________________________________________________________________________________________________________________________
28  ________________________________________________________________________________________________________________________________________________________________
29  ________________________________________________________________________________________________________________________________________________________________
30  ________________________________________________________________________________________________________________________________________________________________
31  ________________________________________________________________________________________________________________________________________________________________
32  ________________________________________________________________________________________________________________________________________________________________
33  ________________________________________________________________________________________________________________________________________________________________
34  ________________________________________________________________________________________________________________________________________________________________
35  ________________________________________________________________________________________________________________________________________________________________
36  ________________________________________________________________________________________________________________________________________________________________
37  ________________________________________________________________________________________________________________________________________________________________
38  ________________________________________________________________________________________________________________________________________________________________
39  __________________________________________________________________________________1_____________________________________________________________________________
40  __________________________________________________________________________________1_____________________________________________________________________________
41  _________________________________________________________________________________1______________________________________________________________________________
42  _________________________________________________________________________________1______________________________________________________________________________
43  _________________________________________________________________________________1______________________________________________________________________________
44  _________________________________________________________________________________1_____________________1________________________________________________________
45  ________________________________________________________________________________1______________________1________________________________________________________
46  ________________________________________________________________________________1_______________________1_______________________________________________________
47  ______________________________________________________________________________11________________________1_______________________________________________________
48  _____________________________________________________________________________1___________________________1______________________________________________________
49  ___________________________________________________________________________11____________________________1______________________________________________________
50  __________________________________________________________________________1______________________________1______________________________________________________
51  ________________________________________________________________________11________________________________1_____________________________________________________
52  _______________________________________________________________________1__________________________________1_____________________________________________________
53  _______________________________________________________________________1__________________________________1_____________________________________________________
54  _______________________________________________________________________1___________________________________1____________________________________________________
55  _______________________________________________________________________1___________________________________1____________________________________________________
56  _______________________________________________________________________1____________________________________1___________________________________________________
57  ______________________________________________________________________1_____________________________________1___________________________________________________
58  ______________________________________________________________________1_____________________________________1___________________________________________________
59  ______________________________________________________________________1_____________________________________1___________________________________________________
60  _____________________________________________________________________1_____________________________________1____________________________________________________
61  __________________________________________________________________1111_____________________________________1____________________________________________________
62  ____________________________________________________1_____________1________________________________________1____________________________________________________
63  ___________________________________________________1_11__________1_________________________________________1____________________________________________________
64  ___________________________________________________1___11111111111__________________________________________1___________________________________________________
65  __________________________________________________1_________________________________________________________1___________________________________________________
66  _1__________________________________________111111___________________________________________________________1__________________________________________________
67  __1_________________________________________1________________________________________________________________1__________________________________________________
68  ___1________________________________________1_________________________________________________________________1_________________________________________________
69  ____1______________________________________1___________________________________________________________________1________________________________________________
70  _____1_____________________________________1___________________________________________________________________1________________________________________________
71  ______1___________________________________11____________________________________________________________________1_______________________________________________
72  _______1________________________________11___1111111111__1111111111____________________________________________1111111111_______________________________________
73  ________1_______________________________1____1111111111________________________________________________________1111111111_______________________________________
74  _________1______________________________1____1111111111________________________________________________________1111111111_______________________________________
75  __________1_____________________________1____1111111111________________________________________________________11111111111111___________________________________
76  ___________1____________________________1____1111111111________________________________________________________1111111111___1___________________________________
77  ____________1__________________________1_____1111111111________________________________________________________1111111111____1__________________________________
78  _____________1_________________________1_______________________________________________________________________1111111111____1__________________________________
79  ______________1________________________1_____________________________________________________________________________________1__________________________________
80  ______________1________________________1_____________________________________________________________________________________1__________________________________
81  _______________1_______________________1______________________________________________________________________________________1_________________________________
82  ________________1____________________11_______________________________________________________________________________________1_________________________________
83  _________________1__________________1_________________________________________________________________________________________1_________________________________
84  __________________1_________________1111111111________________________________________________________________________________1_________________________________
85  ___________________1_______________11111111111_________________________________________________________________________________1________________________________
86  ____________________1______________11111111111_________________________________________________________________________________1________________________________
87  _____________________1____________1_1111111111_________________________________________________________________________________1________________________________
88  ______________________1__________1__1111111111_________________________________________________________________________________1________________________________
89  _______________________1________1_______________________________________________________________________________________________1_______________________________
90  ________________________1______1________________________________________________________________________________________________1_______________________________
91  _________________________1____1_________________________________________________________________________________________________1_______________________________
92  __________________________1___1_________________________________________________________________________________________________1_______________________________
93  ___________________________1_1___________________________________________________________________________________________________1______________________________
94  ____________________________1____________________________________________________________________________________________________1______________________________
95  _________________________________________________________________________________________________________________________________1______________________________
96  _1_______________________________________________________________________________________________________________________________1______________________________
97  __1______________________________________________________________________________________________________________________________1______________________________
98  __1___________________________________________________________________________________________________________111111111111111111111_____________________________
99  ___1__________________________________________________________________________________________________________1___________________1_____________________________
100 ____1_________________________________________________________________________________________________________1___________________1_____________________________
101 _____1________________________________________________________________________________________________________1___________________1_____________________________
102 _____1________________________________________________________________________________________________________111111111111111111111_____________________________
103 ______1_______________________________________________________________________________________________________1___________________1_____________________________
104 _______1______________________________________________________________________________________________________1____________________1____________________________
105 ________1_____________________________________________________________________________________________________1____________________1____________________________
106 ________1_____________________________________________________________________________________________________1____________________1____________________________
107 _________1____________________________________________________________________________________________________1_________111111111111____________________________
108 __________1___________________________________________________________________________________________________1_________1_______________________________________
109 ___________1__________________________________________________________________________________________________1_________1_______________________________________
110 ___________1__________________________________________________________________________________________________1__________1______________________________________
111 ____________1_________________________________________________________________________________________________1___________1_____________________________________
112 _____________1________________________________________________________________________________________________1___________1_____________________________________
113 _____________1________________________________________________________________________________________________1____________1____________________________________
114 _____________1________________________________________________________________________________________________1_____________1___________________________________
115 _____________1________________________________________________________________________________________________1______________1__________________________________
116 _____________1________________________________________________________________________________________________1______________1______1111111_____________________
117 _____________1________________________________________________________________________________________________1_______________111111______1_____________________
118 _____________1________________________________________________________________________________________________1____________________________1____________________
119 ____________11________________________________________________________________________________________________1____________________________1____________________
120 __________11__________________________________________________________________________________________________1____________________________11___________________
121 _________1____________________________________________________________________________________________________1_____________________________1___________________
122 _________1____________________________________________________________________________________________________1_____________________________1___________________
123 _________1____________________________________________________________________________________________________1_____________________________11__________________
124 _________1____________________________________________________________________________________________________1______________________________1__________________
125 ________1_____________________________________________________________________________________________________1______________________________11_________________
126 ________1_____________________________________________________________________________________________________1______________________________11_________________
127 ________1_____________________________________________________________________________________________________1111111111111111111111111111111111________________
128 ________1_________________________________________________________________________________________________________________________4444444444441_________________
129 ________1_____________________________________________________________________________________________________________________________________1_________________
130 _______1______________________________________________________________________________________________________________________________________1_________________
131 _______1______________________________________________________________________________________________________________________________________1_________________
132 _______1________1111111111___________________________________________________________________________________________________________________1__________________
133 _______1________1111111111___________________________________________________________________________________________________________________1__________________
134 ______1_________1111111111___________________________________________________________________________________________________________________1__________________
135 ______1_________1111111111___________________________________________________________________________________________________________________1__________________
136 ______1_________1111111111___________________________________________________________________________________________________________________1__________________
137 ______1_________1111111111___________________________________________________________________________________________________________________1__________________
138 ______1_________1111111111___________________________________________________________________________________________________________________1__________________
139 _____1__________1111111111__________________________________________________________________________________________________________________1___________________
140 _____1__________1111111111__________________________________________________________________________________________________________________1___________________
141 _____1_____________________________________________________________________________________________________________________________________1____________________
142 ______1____________________________________________________________________________________________________________________________________1____________________
143 _______1___________________________________________________________________________________________________________________________________1____________________
144 ________1_____________________1111111111__________________________________________________________________1111111111______________________1_____________________
145 _________1____________________1111111111__________________________________________________________________________________________________1_____________________
146 __________1___________________1111111111__________________________________________________________________________________________________1_____________________
147 __________1___________________1111111111_________________________________________________________________________________________________1______________________
148 ___________1__________________1111111111_________________________________________________________________________________________________1______________________
149 ____________1_________________1111111111________________________________________________________________________________________________1_______________________
150 _____________1________________1111111111________________________________________________________________________________________________1_______________________
151 ______________1__________________________________________________________________________________________________________________________1______________________
152 _______________11111111__________________________________________________________________________________________________________________1______________________
153 ______________________1___________________________________________________________________________________________________________________1_____________________
154 _______________________1__________________________________________________________________________________________________________________1_____________________
155 _______________________1___________________________________________________________________________________________________________________1____________________
156 _______________________1______________________________________________________________________1111111111________________111111111111111111__1___________________
157 ________________________1___________________________________________________________________________________________________________________1___________________
158 ________________________1____________________________________________________________________________________________________________________1__________________
159 _________________________1___________________________________________________________________________________________________________________1__________________
160 _________________________1____________________________________________________________________________________________________________________1_________________
161 _________________________1___________________________________________________________________________________________________________________1__________________
162 __________________________1__________________________________________________________________________________________________________________1__________________
163 __________________________1_________________________________________________________________________________________________________________1___________________
164 __________________________1________________________________________________________________________________________________________________1____________________
165 ___________________________1______________________________________________________________________________________________________________11____________________
166 ___________________________1______________________________________________________________________________________________________________1_____________________
167 ___________________________1______________________________________________________________________________________________________________1_____________________
