    0         10        20        30        40        50        60        70        80        90        100       110       120       130       140       150       
    0123456789012345678901234567890123456789012345678901234567890123456789012345678901234567890123456789012345678901234567890123456789012345678901234567890123456789
0   ________________________________________________________________________________________________________________________________________________________________
1   _11111111111111111111111111111111111111111111111111111111111111111_____________________________________11111111111111111111111111111111111111111111111111111111_
2   _11111111111111111111111111111111111111111111111111111111111111111____________________________________111111111111111111111111111111111111111111111111111111111_
3   _11111111111111111111111111111111111111111111111111111111111111111____________________________________111111111111111111111111111111111111111111111111111111111_
4   _11111111111111111111111111111111111111111111111111111111111111111____________________________________111111111111111111111111111111111111111111111111111111111_
5   _11111111111111111111111111111111111111111111111111111111111111111____________________________________111111111111111111111111111111111111111111111111111111111_
6   _11111111111111111111111111111111111111111111111111111111111111111____________________________________111111111111111111111111111111111111111111111111111111111_
7   _11111111111111111111111111111111111111111111111111111111111111111____________________________________111111111111111111111111111111111111111111111111111111111_
8   _11111111111111111111111111111111111111111111111111111111111111111____________________________________111111111111111111111111111111111111111111111111111111111_
9   _1111111111111111111111111111111111111111111111111111111111111111_____________________________________111111111111111111111111111111111111111111111111111111111_
10  _1111111111111111111111111111111111111111111111111111111111111111_____________________________________111111111111111111111111111111111111111111111111111111111_
11  _1111111111111111111111111111111111111111111111111111111111111111_____________________________________111111111111111111111111111111111111111111111111111111111_
12  _1111111111111111111111111111111111111111111111111111111111111111_____________________________________111111111111111111111111111111111111111111111111111111111_
13  _1111111111111111111111111111111111111111111111111111111111111111_____________________________________111111111111111111111111111111111111111111111111111111111_
14  _1111111111111111111111111111111111111111111111111111111111111111_____________________________________111111111111111111111111111111111111111111111111111111111_
15  _11111111111111111111111111111111111111111111111111111111111111111____________________________________111111111111111111111111111111111111111111111111111111111_
16  _11111111111111111111111111111111111111111111111111111111111111111_____________________________________11111111111111111111111111111111111111111111111111111111_
17  _11111111111111111111111111111111111111111111111111111111111111111_____________________________________11111111111111111111111111111111111111111111111111111111_
18  _11111111111111111111111111111111111111111111111111111111111111111______________________________________1111111111111111111111111111111111111111111111111111111_
19  _11111111111111111111111111111111111111111111111111111111111111111______________________________________1111111111111111111111111111111111111111111111111111111_
20  _11111111111111111111111111111111111111111111111111111111111111111_______________________________________111111111111111111111111111111111111111111111111111111_
21  _11111111111111111111111111111111111111111111111111111111111111111_______________________________________111111111111111111111111111111111111111111111111111111_
22  _11111111111111111111111111111111111111111111111111111111111111111_______________________________________111111111111111111111111111111111111111111111111111111_
23  _11111111111111111111111111111111111111111111111111111111111111111________________________________________11111111111111111111111111111111111111111111111111111_
24  _11111111111111111111111111111111111111111111111111111111111111111________________________________________11111111111111111111111111111111111111111111111111111_
25  _111111111111111111111111111111111111111111111111111111111111111111_______________________________________11111111111111111111111111111111111111111111111111111_
26  _111111111111111111111111111111111111111111111111111111111111111111_______________________________________11111111111111111111111111111111111111111111111111111_
27  _1111111111111111111111111111111111111111111111111111111111111111111_______________________________________1111111111111111111111111111111111111111111111111111_
28  _1111111111111111111111111111111111111111111111111111111111111111111_______________________________________1111111111111111111111111111111111111111111111111111_
29  _11111111111111111111111111111111111111111111111111111111111111111111______________________________________1111111111111111111111111111111111111111111111111111_
30  _11111111111111111111111111111111111111111111111111111111111111111111______________________________________1111111111111111111111111111111111111111111111111111_
31  _11111111111111111111111111111111111111111111111111111111111111111111_____________________________________11111111111111111111111111111111111111111111111111111_
32  _11111111111111111111111111111111111111111111111111111111111111111111_____________________________________11111111111111111111111111111111111111111111111111111_
33  _1111111111111111111111111111111111111111111111111111111111111111111_____________________________________111111111111111111111111111111111111111111111111111111_
34  _1111111111111111111111111111111111111111111111111111111111111111111_____________________________________111111111111111111111111111111111111111111111111111111_
35  _1111111111111111111111111111111111111111111111111111111111111111111____________________________________1111111111111111111111111111111111111111111111111111111_
36  _111111111111111111111111111111111111111111111111111111111111111111_____________________________________1111111111111111111111111111111111111111111111111111111_
37  _111111111111111111111111111111111111111111111111111111111111111111______________________________________111111111111111111111111111111111111111111111111111111_
38  _11111111111111111111111111111111111111111111111111111111111111111_______________________________________111111111111111111111111111111111111111111111111111111_
39  _11111111111111111111111111111111111111111111111111111111111111111_______________________________________111111111111111111111111111111111111111111111111111111_
40  _1111111111111111111111111111111111111111111111111111111111111111_________________________________________11111111111111111111111111111111111111111111111111111_
41  _111111111111111111111111111111111111111111111111111111111111111__________________________________________11111111111111111111111111111111111111111111111111111_
42  _11111111111111111111111111111111111111111111111111111111111111___________________________________________11111111111111111111111111111111111111111111111111111_
43  _11111111111111111111111111111111111111111111111111111111111111____________________________________________1111111111111111111111111111111111111111111111111111_
44  _11111111111111111111111111111111111111111111111111111111111111____________________________________________1111111111111111111111111111111111111111111111111111_
45  _11111111111111111111111111111111111111111111111111111111111111_____________________________________________111111111111111111111111111111111111111111111111111_
46  _11111111111111111111111111111111111111111111111111111111111111_____________________________________________111111111111111111111111111111111111111111111111111_
47  _11111111111111111111111111111111111111111111111111111111111111______________________________________________11111111111111111111111111111111111111111111111111_
48  _11111111111111111111111111111111111111111111111111111111111111_______________________________________________1111111111111111111111111111111111111111111111111_
49  _11111111111111111111111111111111111111111111111111111111111111_______________________________________________1111111111111111111111111111111111111111111111111_
50  _11111111111111111111111111111111111111111111111111111111111111______________________________________________11111111111111111111111111111111111111111111111111_
51  _11111111111111111111111111111111111111111111111111111111111111______________________________________________11111111111111111111111111111111111111111111111111_
52  _11111111111111111111111111111111111111111111111111111111111111_____________________________________________111111111111111111111111111111111111111111111111111_
53  _1111111111111111111111111111111111111111111111111111111111111______________________________________________111111111111111111111111111111111111111111111111111_
54  _1111111111111111111111111111111111111111111111111111111111111_____________________________________________1111111111111111111111111111111111111111111111111111_
55  _111111111111111111111111111111111111111111111111111111111111______________________________________________1111111111111111111111111111111111111111111111111111_
56  _111111111111111111111111111111111111111111111111111111111111______________________________________________1111111111111111111111111111111111111111111111111111_
57  _11111111111111111111111111111111111111111111111111111111111________________________________________________111111111111111111111111111111111111111111111111111_
58  _11111111111111111111111111111111111111111111111111111111111________________________________________________111111111111111111111111111111111111111111111111111_
59  _1111111111111111111111111111111111111111111111111111111111__________________________________________________11111111111111111111111111111111111111111111111111_
60  _111111111111111111111111111111111111111111111111111111111____________________________________________________1111111111111111111111111111111111111111111111111_
61  _11111111111111111111111111111111111111111111111111111111______________________________________________________111111111111111111111111111111111111111111111111_
62  _1111111111111111111111111111111111111111111111111111111________________________________________________________11111111111111111111111111111111111111111111111_
63  _1111111111111111111111111111111111111111111111111111111________________________________________________________11111111111111111111111111111111111111111111111_
64  _111111111111111111111111111111111111111111111111111111__________________________________________________________1111111111111111111111111111111111111111111111_
65  _111111111111111111111111111111111111111111111111111111___________________________________________________________111111111111111111111111111111111111111111111_
66  _11111111111111111111111111111111111111111111111111111____________________________________________________________111111111111111111111111111111111111111111111_
67  _11111111111111111111111111111111111111111111111111111_____________________________________________________________11111111111111111111111111111111111111111111_
68  _11111111111111111111111111111111111111111111111111111______________________________________________________________1111111111111111111111111111111111111111111_
69  _1111111111111111111111111111111111111111111111111111_______________________________________________________________1111111111111111111111111111111111111111111_
70  _1111111111111111111111111111111111111111111111111111________________________________________________________________111111111111111111111111111111111111111111_
71  _1111111111111111111111111111111111111111111111111111________________________________________________________________111111111111111111111111111111111111111111_
72  _1111111111111111111111111111111111111111111111111111_________________________________________________________________11111111111111111111111111111111111111111_
73  _1111111111111111111111111111111111111111111111111111__________________________________________________________________1111111111111111111111111111111111111111_
74  _11111111111111111111111111111111111111111111111111111__________________________________________________________________111111111111111111111111111111111111111_
75  _11111111111111111111111111111111111111111111111111111___________________________________________________________________11111111111111111111111111111111111111_
76  _11111111111111111111111111111111111111111111111111111____________________________________________________________________1111111111111111111111111111111111111_
77  _11111111111111111111111111111111111111111111111111111____________________________________________________________________1111111111111111111111111111111111111_
78  _11111111111111111111111111111111111111111111111111111____________________________________________________________________1111111111111111111111111111111111111_
79  _11111111111111111111111111111111111111111111111111111____________________________________________________________________1111111111111111111111111111111111111_
80  _11111111111111111111111111111111111111111111111111111____________________________________________________________________1111111111111111111111111111111111111_
81  _11111111111111111111111111111111111111111111111111111____________________________________________________________________1111111111111111111111111111111111111_
82  _11111111111111111111111111111111111111111111111111111____________________________________________________________________1111111111111111111111111111111111111_
83  _11111111111111111111111111111111111111111111111111111____________________________________________________________________1111111111111111111111111111111111111_
84  _11111111111111111111111111111111111111111111111111111___________________________________________________________________11111111111111111111111111111111111111_
85  _11111111111111111111111111111111111111111111111111111___________________________________________________________________11111111111111111111111111111111111111_
86  _11111111111111111111111111111111111111111111111111111___________________________________________________________________11111111111111111111111111111111111111_
87  _11111111111111111111111111111111111111111111111111111___________________________________________________________________11111111111111111111111111111111111111_
88  _1111111111111111111111111111111111111111111111111111____________________________________________________________________11111111111111111111111111111111111111_
89  _1111111111111111111111111111111111111111111111111111___________________________________________________________________111111111111111111111111111111111111111_
90  _1111111111111111111111111111111111111111111111111111___________________________________________________________________111111111111111111111111111111111111111_
91  _1111111111111111111111111111111111111111111111111111___________________________________________________________________111111111111111111111111111111111111111_
92  _1111111111111111111111111111111111111111111111111111___________________________________________________________________111111111111111111111111111111111111111_
93  _1111111111111111111111111111111111111111111111111111___________________________________________________________________111111111111111111111111111111111111111_
94  _111111111111111111111111111111111111111111111111111___________________________________________________________1_________11111111111111111111111111111111111111_
95  _111111111111111111111111111111111111111111111111111____________________________________________________________1_1______11111111111111111111111111111111111111_
96  _111111111111111111111111111111111111111111111111111____________________________________________________________111______11111111111111111111111111111111111111_
97  _111111111111111111111111111111111111111111111111111____________________________________________________________1_1_______1111111111111111111111111111111111111_
98  _11111111111111111111111111111111111111111111111111_1___________________________________________________________1_1_______1111111111111111111111111111111111111_
99  _1111111111111111111111111111111111111111111111111___1___________________________________________________________11_______1111111111111111111111111111111111111_
100 _111111111111111111111111111111111111111111111111_____11_________________________________________________________1_1_______111111111111111111111111111111111111_
101 _11111111111111111111111111111111111111111111111________11___1___________________________________________________1_1_______111111111111111111111111111111111111_
102 _1111111111111111111111111111111111111111111111___________1111___________________________________________________111_______111111111111111111111111111111111111_
103 _111111111111111111111111111111111111111111111___________111_1_____________________________________________________11_______11111111111111111111111111111111111_
104 _11111111111111111111111111111111111111111111__________11_1___1_____________________________________________________1_______11111111111111111111111111111111111_
105 _11111111111111111111111111111111111111111111____111111__1____1_____________________________________________________11______11111111111111111111111111111111111_
106 _11111111111111111111111111111111111111111111_111________1____1_____________________________________________________11______11111111111111111111111111111111111_
107 _111111111111111111111111111111111111111111111__________1_____1______________________________________________________1______11111111111111111111111111111111111_
108 _111111111111111111111111111111111111111111111__________1_____1_______________________________________________________1______1111111111111111111111111111111111_
109 _111111111111111111111111111111111111111111111__________1_____1_______________________________________________________11_____1111111111111111111111111111111111_
110 _111111111111111111111111111111111111111111111_________1______1_______________________________________________________1_1____1111111111111111111111111111111111_
111 _11111111111111111111111111111111111111111111__________1_____1________________________________________________________1_1____1111111111111111111111111111111111_
112 _11111111111111111111111111111111111111111111______1___1___11_________________________________________________________1__1___1111111111111111111111111111111111_
113 _1111111111111111111111111111111111111111111_______1___1__1____________________________________________________________1_1____111111111111111111111111111111111_
114 _1111111111111111111111111111111111111111111______1____1__1____________________________________________________________1_1____111111111111111111111111111111111_
115 _111111111111111111111111111111111111111111_______1___1__1_____________________________________________________________1_1____111111111111111111111111111111111_
116 _111111111111111111111111111111111111111111_______1___1__1_____________________________________________________________1_1____111111111111111111111111111111111_
117 _111111111111111111111111111111111111111111_______1___111______________________________________________________________1_1____111111111111111111111111111111111_
118 _111111111111111111111111111111111111111111_______1___1________________________________________________________________1_1____111111111111111111111111111111111_
119 _111111111111111111111111111111111111111111_______1____________________________________________________________________1_1____111111111111111111111111111111111_
120 _111111111111111111111111111111111111111111______1_____________________________________________________________________1_1____111111111111111111111111111111111_
121 _111111111111111111111111111111111111111111______1______________11_____________________________________________________1_1____111111111111111111111111111111111_
122 _111111111111111111111111111111111111111111______11_____________11_____________________________________________________1_1____111111111111111111111111111111111_
123 _111111111111111111111111111111111111111111______11_____________11_____________________________________________________1_1____111111111111111111111111111111111_
124 _111111111111111111111111111111111111111111______11_____________11_____________________________________________________1_1_____11111111111111111111111111111111_
125 _111111111111111111111111111111111111111111______11_____________1_1____________________________________________________1_1_____11111111111111111111111111111111_
126 _111111111111111111111111111111111111111111_____1_1_____________1_1____________________________________________________1_1_____11111111111111111111111111111111_
127 _111111111111111111111111111111111111111111_____1_1_____________1__1___________________________________________________1_1_____11111111111111111111111111111111_
128 _111111111111111111111111111111111111111111_____1__1____________1__1___________________________________________________1_1_____11111111111111111111111111111111_
129 _111111111111111111111111111111111111111111_____1__1____________1___1_________________________________________________1__1_____11111111111111111111111111111111_
130 _11111111111111111111111111111111111111111______1__1____________1___1_________________________________________________1__1_____11111111111111111111111111111111_
131 _11111111111111111111111111111111111111111_______1_1____________1____1________________________________________________1__1_____11111111111111111111111111111111_
132 _11111111111111111111111111111111111111111_______1_1____________1____1_______________________________________________1___1_____11111111111111111111111111111111_
133 _11111111111111111111111111111111111111111_______1__1___________1_____1______________________________________________1__1_____111111111111111111111111111111111_
134 _11111111111111111111111111111111111111111_______1__1___________1_____1_____________________________________________1___1_____111111111111111111111111111111111_
135 _11111111111111111111111111111111111111111_______1__1___________1____1______________________________________________1__1_____1111111111111111111111111111111111_
136 _11111111111111111111111111111111111111111________1__1___________11__1______________________________________________1_1______1111111111111111111111111111111111_
137 _111111111111111111111111111111111111111111_______1__1_____________11______________________________________________1_1______11111111111111111111111111111111111_
138 _111111111111111111111111111111111111111111_______1___1____________________________________________________________11_______11111111111111111111111111111111111_
139 _111111111111111111111111111111111111111111_______1___1___________________________________________________________11_______111111111111111111111111111111111111_
140 _111111111111111111111111111111111111111111________1__1___________________________________________________________1_______1111111111111111111111111111111111111_
141 _1111111111111111111111111111111111111111111_______1__1___________________________________________________________________1111111111111111111111111111111111111_
142 _111111111111111111111111111111111111111111111______1__1_________________________________________________________________11111111111111111111111111111111111111_
143 _111111111111111111111111111111111111111111111______1__1_________________________________________________________________11111111111111111111111111111111111111_
144 _111111111111111111111111111111111111111111111_______1__1_______________________________________________________________111111111111111111111111111111111111111_
145 _1111111111111111111111111111111111111111111111_______1_1______________________________________________________________1111111111111111111111111111111111111111_
146 _1111111111111111111111111111111111111111111111________1_1____________________________________________________________11111111111111111111111111111111111111111_
147 _1111111111111111111111111111111111111111111111________1_1___________________________________________________________111111111111111111111111111111111111111111_
148 _1111111111111111111111111111111111111111111111_________11__________________________________________________________1111111111111111111111111111111111111111111_
149 _1111111111111111111111111111111111111111111111_________1_1_________________________________________________________1111111111111111111111111111111111111111111_
150 _1111111111111111111111111111111111111111111111__________11_________________________________________________________1111111111111111111111111111111111111111111_
151 _1111111111111111111111111111111111111111111111__________11______________1111111________3333________________________1111111111111111111111111111111111111111111_
152 _1111111111111111111111111111111111111111111111___________1____________3133333331______31111111_____________________1111111111111111111111111111111111111111111_
153 _1111111111111111111111111111111111111111111111___________1___________3133333333313__331333333331133________________1111111111111111111111111111111111111111111_
154 _11111111111111111111111111111111111111111111111__________1__________31333333333331333133333333333133_______________1111111111111111111111111111111111111111111_
155 _11111111111111111111111111111111111111111111111__________1_____31111133333333333331113333333333333113______________1111111111111111111111111111111111111111111_
156 _1111111111111111111111111111111111111111111111___________1____31333333333333333333333333333333333333133____________1111111111111111111111111111111111111111111_
157 _1111111111111111111111111111111111111111111111___________1___31333333333333333333333333333333333333331133__________1111111111111111111111111111111111111111111_
158 _11111111111111111111111111111111111111111111111_____________3133333333333333333333333333333333333333333111_3______11111111111111111111111111111111111111111111_
159 _11111111111111111111111111111111111111111111111____________313333333333333333333333333333333333333333333331_______11111111111111111111111111111111111111111111_
160 _111111111111111111111111111111111111111111111111__________31333333333333333333333333333333333333333333333331______11111111111111111111111111111111111111111111_
161 _111111111111111111111111111111111111111111111111_________3133333333333333333333333333333333333333333333333313_____11111111111111111111111111111111111111111111_
162 _1111111111111111111111111111111111111111111111111_______33133333333333333333333333333333333333333333333333331____111111111111111111111111111111111111111111111_
163 _1111111111111111111111111111111111111111111111111______3313333333333333333333333333333333333333333333333333313___111111111111111111111111111111111111111111111_
164 _11111111111111111111111111111111111111111111111111_____31333333333333333333333333333333333333333333333333333313__111111111111111111111111111111111111111111111_
165 _111111111111111111111111111111111111111111111111111___313333333333333333333333333333333333333333333333333333313_1111111111111111111111111111111111111111111111_
166 _111111111111111111111111111111111111111111111111111__3133333333333333333333333333333333333333333333333333333313_1111111111111111111111111111111111111111111111_
167 ___________________________________________________111113333333333333333333333333333333333333333333333333333331111______________________________________________
