    0         10        20        30        40        50        60        70        80        90        100       110       120       130       140       150       
    0123456789012345678901234567890123456789012345678901234567890123456789012345678901234567890123456789012345678901234567890123456789012345678901234567890123456789
0   ________________________________________________________________________________________________________________________________________________________________
1   _______________________________________________________________________________11111111111______________________________________________________________________
2   _______________________________________________________________________________11111111111______________________________________________________________________
3   _______________________________________________________________________________11111111111______________________________________________________________________
4   _______________________________________________________________________________11111111111______________________________________________________________________
5   _______________________________________________________________________________11111111111______________________________________________________________________
6   _______________________________________________________________________________11111111111______________________________________________________________________
7   _______________________________________________________________________________11111111111______________________________________________________________________
8   _______________________________________________________________________________11111111111______________________________________________________________________
9   _______________________________________________________________________________11111111111______________________________________________________________________
10  _______________________________________________________________________________11111111111______________________________________________________________________
11  _______________________________________________________________________________11111111111______________________________________________________________________
12  _______________________________________________________________________________11111111111______________________________________________________________________
13  _______________________________________________________________________________11111111111______________________________________________________________________
14  _______________________________________________________________________________11111111111______________________________________________________________________
15  _______________________________________________________________________________11111111111______________________________________________________________________
16  _______________________________________________________________________________11111111111______________________________________________________________________
17  _______________________________________________________________________________11111111111______________________________________________________________________
18  _______________________________________________________________________________11111111111______________________________________________________________________
19  _______________________________________________________________________________11111111111______________________________________________________________________
20  _______________________________________________________________________________11111111111______________________________________________________________________
21  _______________________________________________________________________________11111111111______________________________________________________________________
22  _______________________________________________________________________________11111111111______________________________________________________________________
23  _______________________________________________________________________________11111111111__________________________________________________________________2___
24  _______________________________________________________________________________11111111111__________________________________________________________________2___
25  _______________________________________________________________________________11111111111__________________________________________________________________2___
26  _______________________________________________________________________________11111111111__________________________________________________________________2___
27  _______________________________________________________________________________11111111111__________________________________________________________________2___
28  _______________________________________________________________________________11111111111__________________________________________________________________2___
29  _______________________________________________________________________________11111111111__________________________________________________________________2___
30  _______________________________________________________________________________11111111111__________________________________________________________________2___
31  _______________________________________________________________________________11111111111__________________________________________________________________2___
32  _______________________________________________________________________________11111111111__________________________________________________________________2___
33  _______________________________________________________________________________11111111111__________________________________________________________________2___
34  _______________________________________________________________________________11111111111__________________________________________________________________2___
35  _______________________________________________________________________________11111111111__________________________________________________________________2___
36  _______________________________________________________________________________11111111111__________________________________________________________________2___
37  _______________________________________________________________________________11111111111__________________________________________________________________2___
38  _______________________________________________________________________________11111111111__________________________________________________________________2___
39  _______________________________________________________________________________11111111111__________________________________________________________________2___
40  _______________________________________________________________________________11111111111__________________________________________________________________2___
41  _______________________________________________________________________________11111111111__________________________________________________________________2___
42  _______________________________________________________________________________11111111111__________________________________________________________________2___
43  _______________________________________________________________________________11111111111__________________________________________________________________2___
44  _______________________________________________________________________________11111111111__________________________________________________________________2___
45  _______________________________________________________________________________111111111____________________________________________________________________2___
46  ________________________________________________________________________________111111______________________________________________________________________2___
47  __________________________________________________________________________________11________________________________________________________________________2___
48  ____________________________________________________________________________________________________________________________________________________________2___
49  ____________________________________________________________________________________________________________________________________________________________2___
50  ____________________________________________________________________________________________________________________________________________________________2___
51  ____________________________________________________________________________________________________________________________________________________________2___
52  ____________________________________________________________________________________________________________________________________________________________2___
53  ____________________________________________________________________________________________________________________________________________________________2___
54  ____________________________________________________________________________________________________________________________________________________________2___
55  ____________________________________________________________________________________________________________________________________________________________2___
56  ____________________________________________________________________________________________________________________________________________________________2___
57  ____________________________________________________________________________________________________________________________________________________________2___
58  ____________________________________________________________________________________________________________________________________________________________2___
59  ____________________________________________________________________________________________________________________________________________________________2___
60  ____________________________________________________________________________________________________________________________________________________________2___
61  ____________________________________________________________________________________________________________________________________________________________2___
62  ____________________________________________________________________________________________________________________________________________________________2___
63  ____________________________________________________________________________________________________________________________________________________________2___
64  ____________________________________________________________________________________________________________________________________________________________2___
65  ____________________________________________________________________________________________________________________________________________________________2___
66  ____________________________________________________________________________________________________________________________________________________________2___
67  ____________________________________________________________________________________________________________________________________________________________2___
68  ____________________________________________________________________________________________________________________________________________________________2___
69  ____________________________________________________________________________________________________________________________________________________________2___
70  ____________________________________________________________________________________________________________________________________________________________2___
71  ____________________________________________________________________________________________________________________________________________________________2___
72  ____________________________________________________________________________________________________________________________________________________________2___
73  ____________________________________________________________________________________________________________________________________________________________2___
74  ____________________________________________________________________________________________________________________________________________________________2___
75  ____________________________________________________________________________________________________________________________________________________________2___
76  ____________________________________________________________________________________________________________________________________________________________2___
77  ____________________________________________________________________________________________________________________________________________________________2___
78  ____________________________________________________________________________________________________________________________________________________________2___
79  ____________________________________________________________________________________________________________________________________________________________2___
80  ____________________________________________________________________________________________________________________________________________________________2___
81  ____________________________________________________________________________________________________________________________________________________________2___
82  ____________________________________________________________________________________________________________________________________________________________2___
83  ____________________________________________________________________________________________________________________________________________________________2___
84  ___________________________________________________________________________________________________________________________________________________________2____
85  ___________________________________________________________________________________________________________________________________________________________2____
86  ___________________________________________________________________________________________________________________________________________________________2____
87  ___________________________________________________________________________________________________________________________________________________________2____
88  ___________________________________________________________________________________________________________________________________________________________2____
89  ___________________________________________________________________________________________________________________________________________________________2____
90  ___________________________________________________________________________________________________________________________________________________________2____
91  ___________________________________________________________________________________________________________________________________________________________2____
92  ___________________________________________________________________________________________________________________________________________________________2____
93  ___________________________________________________________________________________________________________________________________________________________2____
94  ___________________________________________________________________________________________________________________________________________________________2____
95  ___________________________________________________________________________________________________________________________________________________________2____
96  _______________________________________________________________________________________________________________________111111111111111111111111111_________2____
97  ______________________________________________________________________________________________________________________1_1___1___1___1___1___1___1_1________2____
98  _____________________________________________________________________________________________________________________1__1___1___1___1___1___1___1_1________2____
99  ____________________________________________________________________________________________________________________1___1___1___1___1___1___1___1__1_______2____
100 _____________________________________________________________________________________________________________________1__1___1___1___1___1___1___1__1_______2____
101 ______________________________________________________________________________________________________________________1_1___1111111111111___1___1111_______2____
102 _______________________________________________________________________________________________________________________11111111________1___111111__________2____
103 ________________________________________________________________________________________________________________________________________111________________2____
104 ___________________________________________________________________________________________________________________________________________________________2____
105 ___________________________________________________________________________________________________________________________________________________________2____
106 ___________________________________________________________________________________________________________________________________________________________2____
107 ___________________________________________________________________________________________________________________________________________________________2____
108 ___________________________________________________________________________________________________________________________________________________________2____
109 ___________________________________________________________________________________________________________________________________________________________2____
110 ___________________________________________________________________________________________________________________________________________________________2____
111 ___________________________________________________________________________________________________________________________________________________________2____
112 ___________________________________________________________________________________________________________________________________________________________2____
113 ___________________________________________________________________________________________________________________________________________________________2____
114 ___________________________________________________________________________________________________________________________________________________________2____
115 ___________________________________________________________________________________________________________________________________________________________2____
116 ___________________________________________________________________________________________________________________________________________________________2____
117 ___________________________________________________________________________________________________________________________________________________________2____
118 ___________________________________________________________________________________________________________________________________________________________2____
119 ___________________________________________________________________________________________________________________________________________________________2____
120 ___________________________________________________________________________________________________________________________________________________________2____
121 ___________________________________________________________________________________________________________________________________________________________2____
122 ___________________________________________________________________________________________________________________________________________________________2____
123 ___________________________________________________________________________________________________________________________________________________________2____
124 ___________________________________________________________________________________________________________________________________________________________2____
125 ___________________________________________________________________________________________________________________________________________________________2____
126 ___________________________________________________________________________________________________________________________________________________________2____
127 ___________________________________________________________________________________________________________________________________________________________2____
128 ___________________________________________________________________________________________________________________________________________________________2____
129 ___________________________________________________________________________________________________________________________________________________________2____
130 ___________________________________________________________________________________________________________________________________________________________2____
131 ___________________________________________________________________________________________________________________________________________________________2____
132 ___________________________________________________________________________________________________________________________________________________________2____
133 ___________________________________________________________________________________________________________________________________________________________2____
134 ___________________________________________________________________________________________________________________________________________________________2____
135 ___________________________________________________________________________________________________________________________________________________________2____
136 ___________________________________________________________________________________________________________________________________________________________2____
137 ___________________________________________________________________________________________________________________________________________________________2____
138 ___________________________________________________________________________________________________________________________________________________________2____
139 ___________________________________________________________________________________________________________________________________________________________2____
140 ___________________________________________________________________________________________________________________________________________________________2____
141 ___________________________________________________________________________________________________________________________________________________________2____
142 ___________________________________________________________________________________________________________________________________________________________2____
143 ___________________________________________________________________________________________________________________________________________________________2____
144 ______________111111111111_________________________________________________________________________________________________________________________________2____
145 ______________1__________1________________________________________________________________________________________________________________________________2_____
146 ______________1__________1________________________________________________________________________________________________________________________________2_____
147 ______________1__________1_______________________________________________________________________________________________________________________________2______
148 ______________111111111111_______________________________________________________________________________________________________________________________2______
149 ________________________________________________________________________________________________________________________________________________________2_______
150 ________________________________________________________________________________________________________________________________________________________2_______
151 _______________________________________________________________________________________________________________________________________________________2________
152 ______________________________________________________________________________________________________________________________________________________22________
153 ____________________________________________________________________________________________________________________________________________________22__________
154 _________________________________________________________________________________________________________________________________________________222____________
155 _______________________________________________________________________________________________________11111___________________________________22_______________
156 _______________________________________________________________________________________________________1___1_________________________________22_________________
157 _______________________________________________________________________________________________________1___1______________________________222___________________
158 _______________________________________________________________________________________________________1___1____________________________22______________________
159 _222222222222222222222222222222222222222222222222222222222222222222222222222222222222222222222222222222222222222222222222222222222222222________________________
160 ________________________________________________________________________________________________________________________________________________________________
161 ________________________________________________________________________________________________________________________________________________________________
162 ________________________________________________________________________________________________________________________________________________________________
163 ________________________________________________________________________________________________________________________________________________________________
164 ________________________________________________________________________________________________________________________________________________________________
165 ________________________________________________________________________________________________________________________________________________________________
166 ________________________________________________________________________________________________________________________________________________________________
167 ________________________________________________________________________________________________________________________________________________________________
