    0         10        20        30        40        50        60        70        80        90        100       110       120       130       140       150       
    0123456789012345678901234567890123456789012345678901234567890123456789012345678901234567890123456789012345678901234567890123456789012345678901234567890123456789
0   ________________________________________________________________________________________________________________________________________________________________
1   ________________________________________________________________________________________________________________________________________________________________
2   ________________________________________________________________________________________________________________________________________________________________
3   ________________________________________________________________________________________________________________________________________________________________
4   ________________________________________________________________________________________________________________________________________________________________
5   ________________________________________________________________________________________________________________________________________________________________
6   ________________________________________________________________________________________________________________________________________________________________
7   ________________________________________________________________________________________________________________________________________________________________
8   ________________________________________________________________________________________________________________________________________________________________
9   ________________________________________________________________________________________________________________________________________________________________
10  ________________________________________________________________________________________________________________________________________________________________
11  ________________________________________________________________________________________________________________________________________________________________
12  ________________________________________________________________________________________________________________________________________________________________
13  ________________________________________________________________________________________________________________________________________________________________
14  ________________________________________________________________________________________________________________________________________________________________
15  ________________________________________________________________________________________________________________________________________________________________
16  ________________________________________________________________________________________________________________________________________________________________
17  ________________________________________________________________________________________________________________________________________________________________
18  ________________________________________________________________________________________________________________________________________________________________
19  ________________________________________________________________________________________________________________________________________________________________
20  ________________________________________________________________________________________________________________________________________________________________
21  ________________________________________________________________________________________________________________________________________________________________
22  ________________________________________________________________________________________________________________________________________________________________
23  ________________________________________________________________________________________________________________________________________________________________
24  ________________________________________________________________________________________________________________________________________________________________
25  ________________________________________________________________________________________________________________________________________________________________
26  ________________________________________________________________________________________________________________________________________________________________
27  ________________________________________________________________________________________________________________________________________________________________
28  ________________________________________________________________________________________________________________________________________________________________
29  ________________________________________________________________________________________________________________________________________________________________
30  ________________________________________________________________________________________________________________________________________________________________
31  ________________________________________________________________________________________________________________________________________________________________
32  ________________________________________________________________________________________________________________________________________________________________
33  ________________________________________________________________________________________________________________________________________________________________
34  ________________________________________________________________________________________________________________________________________________________________
35  ________________________________________________________________________________________________________________________________________________________________
36  ________________________________________________________________________________________________________________________________________________________________
37  ________________________________________________________________________________________________________________________________________________________________
38  ________________________________________________________________________________________________________________________________________________________________
39  _____________________________________________________________________3333333333_3333__3333__3333333333333_______________________________________________________
40  _________________________________________________________3___________3333333333_3333__3333__3333333333333_______________________________________________________
41  _________________________________________________________3___________3333333333_3333__3333__3333333333333_______________________________________________________
42  ______________________________________________________3__3___________3333333333_3333__3333__3333333333333_______________________________________________________
43  _____________________________________________________33__3___________3333333333_3333__3333__3333333333333_______________________________________________________
44  ___________________________________________________3333__3___________3333333333_3333__3333_33333333333333_______________________________________________________
45  __________________________________________________33333__3___________3333333333_3333__3333_333333333333333______________________________________________________
46  ________________________________________________3333333__3__3________3333333333_3333__3333_333333333333333______________________________________________________
47  ______________________________________________333333333__3__3________3333333333_3333__3333_333333333333333______________________________________________________
48  ____________________________________________333333333333_3__3________333333333333333__3333_333333333333333______________________________________________________
49  ___________________________________________3333333333333_3__3________333333333333333__3333_333333333333333______________________________________________________
50  _________________________________________333333333333333_3__3________33333333__33333_333333333333333333333______________________________________________________
51  ________________________________________3333333333333333_3__3__________3333______333_333333333333333333333______________________________________________________
52  _______________________________________33333333333333333_3__3____________3________33_333333333333333333333______________________________________________________
53  ______________________________________333333333333333333_3__3_____________________33_3333333333333333333333_____________________________________________________
54  _____________________________________3333333333333333333_3__3________3____________33_3333333333333333333333_____________________________________________________
55  ____________________1111111111_____333333333333333333333_3__3________3333________333_33333333333333333333333__________11111111111_______________________________
56  ___________________1_________1____3333333333333333333333_3__3________333333_____33333333333333333333333333333__1111111___________11111__________________________
57  ___________________1_________1___33333333333333333333333_3__3________333333_____33333333333333333333333333333__1_____________________1__________________________
58  ___________________1_________1__333333333333333333333333_3__3________333333_____333333333333333333333333333333_1_____________________1__________________________
59  ___________________11111111111_3333333333333333333333333_3__3________3333333___3333333333333333333333333333333_11111111111111111111111__________________________
60  _____________________________333333333333333333333333333_3__3________3333333___33333333333333333333333333333333_________________________________________________
61  ____________________________3333333333333333333333333333_3__3________3333333___3333333333333333333333333333333333_______________________________________________
62  __________________________333333333333333333333333333333_3__3________3333333___333333333333333333333333333333333333_____________________________________________
63  ________________________3333333333333333333333333333333333__3________3333333___33333333333333333333333333333333333333___________________________________________
64  _______________________33333333333333333333333333333333333__3________33333333__3333333333333333333333333333333333333333_________________________________________
65  _____________________33333333333333333333333333333333333333_3________33333333__333333333333333333333333333333333333333333_______________________________________
66  _____________________33333333333333333333333333333333333333_3________33333333__3333333333333333333333333333333333333333333______________________________________
67  _____________________33333333333333333333333333333333333333_3________33333333_33333333333333333333333333333333333333333333______________________________________
68  _____________________33333333333333333333333333333333333333_3________33333333_333333333333333333333333333333333333333333333333333_______________________________
69  _____________________33333333333333333333333333333333333333_3________33333333_33333333333333333333333333333333333333333333333333333333333_______________________
70  _____________________33333333333333333333333333333333333333_3________33333333_333333333333333333333333333333333333333333333333333333333333______________________
71  ____________________333333333333333333333333333333333333333_3________33333333_3333333333333333333333333333333333333333333333333333333333333_____________________
72  ____________________333333333333333333333333333333333333333_3________33333333_3333333333333333333333333333333333333333333333333333333333333_____________________
73  ___________________3333333333333333333333333333333333333333_3________33333333_33333333333333333333333333333333333333333333333333333333333333____________________
74  ___________________3333333333333333333333333333333333333333_3________33333333_333333333333333333333333333333333333333333333333333333333333333___________________
75  ___________________3333333333333333333333333333333333333333_3________33333333_333333333333333333333333333333333333333333333333333333333333333___________________
76  __________________3333333333333333333333333333333333333333333________3333333333333333333333333333333333333333333333333333333333333333333333333__________________
77  __________________3333333333333333333333333333333333333333333________3333333333333333333333333333333333333333333333333333333333333333333333333__________________
78  _________________33333333333333333333333333333333333333333333________33333333333333333333333333333333333333333333333333333333333333333333333333_________________
79  _________________33333333333333333333333333333333333333333333________33333333333333333333333333333333333333333333333333333333333333333333333333_________________
80  ________________333333333333333333333333333333333333333333333________33333333333333333333333333333333333333333333333333333333333333333333333333_________________
81  ________________333333333333333333333333333333333333333333333________333333333333333333333333333333333333333333333333333333333333333333333333333________________
82  _______________3333333333333333333333333333333333333333333333________333333333333333333333333333333333333333333333333333333333333333333333333333________________
83  _______________3333333333333333333333333333333333333333333333________3333333333333333333333333333333333333333333333333333333333333333333333333333_______________
84  ______________33333333333333333333333333333333333333333333333________3333333333333333333333333333333333333333333333333333333333333333333333333333_______________
85  ______________33333333333333333333333333333333333333333333333________3333333333333333333333333333333333333333333333333333333333333333333333333333_______________
86  _____________333333333333333333333333333333333333333333333333________3333333333333333333333333333333333333333333333333333333333333333333333333333_______________
87  _____________333333333333333333333333333333333333333333333333________3333333333333333333333333333333333333333333333333333333333333333333333333333_______________
88  _____________333333333333333333333333333333333333333333333333________3333333333333333333333333333333333333333333333333333333333333333333333333333_______________
89  _____________333333333333333333333333333333333333333333333333________33333333333333333333333333333333333333333333333333333333333333333333333333333______________
90  ______________33333333333333333333333333333333333333333333333________33333333333333333333333333333333333333333333333333333333333333333333333333333______________
91  ______________33333333333333333333333333333333333333333333333________33333333333333333333333333333333333333333333333333333333333333333333333333333______________
92  ______________33333333333333333333333333333333333333333333333________33333333333333333333333333333333333333333333333333333333333333333333333333333______________
93  ______________33333333333333333333333333333333333333333333333________33333333333333333333333333333333333333333333333333333333333333333333333333333______________
94  ______________33333333333333333333333333333333333333333333333________33333333333333333333333333333333333333333333333333333333333333333333333333333______________
95  _______________3333333333333333333333333333333333333333333333________33333333333333333333333333333333333333333333333333333333333333333333333333333______________
96  _______________3333333333333333333333333333333333333333333333________33333333333333333333333333333333333333333333333333333333333333333333333333333______________
97  _______________3333333333333333333333333333333333333333333333________33333333333333333333333333333333333333333333333333333333333333333333333333333______________
98  _______________3333333333333333333333333333333333333333333333________33333333333333333333333333333333333333333333333333333333333333333333333333333______________
99  _______________3333333333333333333333333333333333333333333333________33333333333333333333333333333333333333333333333333333333333333333333333333333______________
100 _______________3333333333333333333333333333333333333333333333_________33333333333333333333333333333333333333333333333333333333333333333333333333333_____________
101 _______________3333333333333333333333333333333333333333333333_________33333333333333333333333333333333333333333333333333333333333333333333333333333_____________
102 _______________3333333333333333333333333333333333333333333333_________33333333333333333333333333333333333333333333333333333333333333333333333333333_____________
103 ______________33333333333333333333333333333333333333333333333_________33333333333333333333333333333333333333333333333333333333333333333333333333333_____________
104 ______________33333333333333333333333333333333333333333333333_________33333333333333333333333333333333333333333333333333333333333333333333333333333_____________
105 ______________33333333333333333333333333333333333333333333333_________33333333333333333333333333333333333333333333333333333333333333333333333333333_____________
106 ______________3333333333333333333333333333333333333333333333___________3333333333333333333333333333333333333333333333333333333333333333333333333333_____________
107 ______________3333333333333333333333333333333333333333333333___________333333333333333333333333333333333333333333333333333333333333333333333333333______________
108 ______________3333333333333333333333333333333333333333333333___________333333333333333333333333333333333333333333333333333333333333333333333333333______________
109 ______________3333333333333333333333333333333333333333333333___________3333333333333333333333333333333333333333333333__33333333333333333333333333_______________
110 ______________3333333333333333333333333333333333333333333333___________333333333333333333333333333333333333333333333____3333333333333333333333333_______________
111 ______________3333333333333333333333333333333333333333333333___________333333333333333333333333333333333333333333333_____33333333333333333333333________________
112 ______________333333333333333333333333333333333333333333333_____________3333333333333333333333333333333333333333333______33333333333333333333333________________
113 ______________333333333333333333333333333333333333333333333_____________3333333333333333333333333333333333333333333_______333333333333333333333_________________
114 ______________333333333333333333333333333333333333333333333_____________3333333333333333333333333333333333333333333_______33333333333333333333__________________
115 _____________3333333333333333333333333333333333333333333333_____________333333333333333333333333333333333333333333________3333333333333333333___________________
116 _____________3333333333333333333333333333333333333333333333_____________333333333333333333333333333333333333333333________333333333333333333____________________
117 _____________3333333333333333333333333333333333333333333333______________33333333333333333333333333333333333333333________33333333333333333_____________________
118 _____________3333333333333333333333333333333333333333333333______________3333333333333333333333333333333333333333_________3333333333333333______________________
119 _____________3333333333333333333333333333333333333333333333_______________33333333333333333333333333333333333333___________33333333333__________________________
120 _____________333333333333333333333333333333333333333333333________________3333333333333333333333333333333333331111111111111333333_______________________________
121 _____________333333333333333333333333333333333333333333333_________________33333333333333333333333333333333311____________1333333_______________________________
122 _____________333333333333333333333333333333333333333333333_________________3333333333333333333333333333333331_____________1333333_______________________________
123 _____________333333333333333333333333333333333333333333333__________________33333333333333333333333333333331______________133333________________________________
124 ______________33333333333333333333333333333333333333333333__________3_______33333333333333333333333333333331_____________1_33333________________________________
125 ______________3333333333333333333333333333333333333333333___________3________333333333333333333333333333331_____________11333333________________________________
126 ______________3333333333333333333333333333333333333333333___________33_______33333333333333333333333333333111111____111133333333________________________________
127 ______________333333333333333333333333333333333333333333____________3333______333333333333333333333333333333333_1111333333333333________________________________
128 ______________333333333333333333333333333333333333333333____________3333______33333333333333333333___333333333333333333333333333________________________________
129 ______________33333333333333333333333333333333333333333_____________33333______333333333333333333____33333333333333333333333333_________________________________
130 _______________3333333333333333333333333333333333333333_____________33333______33333333333333333______3333333333333333333333333_________________________________
131 _______________3333333333333333333333333333333333333333_____3_______33333______3333333333333333_______33333333333333333333333___________________________________
132 _______________333333333333333333333333333333333333333______3_______333333_____333333333333333_________33333333333333333333_____________________________________
133 _______________333333333333333333333333333333333333333______3______3333333______3333333333333__________33333333333333333333_____________________________________
134 _______________33333333333333333333333333333333333333_______3______3333333______333333333333___________3333333333333333333______________________________________
135 _______________33333333333333333333333333333333333333______33______33333333_____333333333333___________3333333333333333333______________________________________
136 _______________33333333333333333333333333333333333333______33______33333333______3333333333_____________33333333333333333_______________________________________
137 _______________3333333333333333333333333333333333333_______33______33333333______3333333333_____________33333333333333333_______________________________________
138 ______________33333333333333333333333333333333333333______3333_____333333333_____333333333______________33333333333333333_______________________________________
139 ______________33333333333333333333333333333333333333______3333_____333333333______33333333_______________333333333333333________________________________________
140 ______________3333333333333333333333333333333333333_______3333_____333333333______3333333_________________33333333333333_____________1111111111_________________
141 ______________333333333333333333333333333333333333311111111111111111111111111111__33333331111111111111____3333333333333__________1111__1___1___11111111_________
142 ______________3333333333333333333333333333333333331___1__313331___1333133313__1_1_3333331111111111111_11___333333333333______1111______1___111111111111_________
143 ______________3333333333333333333333333333333333331___1111133_1___1_3313331___1__1_333331111111111__1___13333333333333___11111111____111111111111111111_________
144 _______________333333333333333333333333333333333331111111111111___13__111111111111133333333333333311111113333333333333311___1___1____1__________________________
145 _______________33333333333333333333333333333333333333333333_331___1111111133333331_13333333333333333333333333333333333311___1___1__111__________________________
146 ________________33333333333333333333333333333333333333333333331___1333333333333331__1333333333333333333333333333333333333111113_1_11____________________________
147 _________________3333333333333333333333333333333333333333333331111133333333333331____133333333333333333333333333333333333333331111_333__________________________
148 __________________3333333333333333333333333333333333333333333311__133333333333331_____133333333333333333333333333333333333333331133333__________________________
149 __________________333333333333333333333333333333333333333333333311333333333333331______133333333333333333333333333333333333333333333333_________________________
150 ___________________333333333333333333333333333333333333333333333333333333333333311____113333333333333___3333333333333333333333333333333_________________________
151 ____________________33333333333333333333333333333333333333333333333333333333333333111133333333333333_____3333333333333333333333333333333________________________
152 _____________________3333333333333333333333333333333333333333333333333333333333333333333333333333333______3333333333333333333333333333333_______________________
153 _____________________333333333333333333333333333333333333333333333333333333333333333333333333333333________333333333333333333333333333333_______________________
154 ______________________33333333333333333333333333333333333333333333333333333333333333333333333333333___1111__333333333333333333333333333333______________________
155 _______________________3333333333333333333333333333333333333333333333333333333333333333333333333331111___111133333333333333333333333333333______________________
156 ________________________3333333333333333333333333333333333333333333333333333333333333333333333333333111111133333333333333333333333333333333_____________________
157 ________________________3333333333333333333333333333333333333333333333333333333333333333333333333333333333333333333333333333333333333333333_____________________
158 _________________________33333333333333333333333333333333333333333333333333333333333333333333333333333333333333333333333333333333333333333______________________
159 ___________________________333333333333333333333333333333333333333333333333333333333333333333333333333333333333333333333333333333333333333______________________
160 _____________________________3333333333333333333333333333333333333333333333333333333333333333333333333333333333333333333333333333333333333______________________
161 ______________________________33333333333333333333333333333333333333333333333333333333333333333333333333333333333333333333333333333333333_______________________
162 ________________________________333333333333333333333333333333333333333333333333333333333333333333333333333333333333333333333333333333333_______________________
163 __________________________________3333333333333333333333333333333333333333333333333333333333333333333333333333333333333333333333________________________________
164 ______________________________________3333333333333333333333333333333333333333333333333333333333333333333333333333333333333333__________________________________
165 ____________________________________________333333333333333333333333333333333333333333333333333333333333333333333333333_________________________________________
166 ________________________________________________33333333333333333333333333333333333333333333333333333333333333333_______________________________________________
167 ________________________________________________3333333333333333333333333333333333333333333333333333333333333333333_____________________________________________
