    0         10        20        30        40        50        60        70        80        90        100       110       120       130       140       150       
    0123456789012345678901234567890123456789012345678901234567890123456789012345678901234567890123456789012345678901234567890123456789012345678901234567890123456789
0   ________________________________________________________________________________________________________________________________________________________________
1   _____________________________________________________________________111111111111111111111111111___________________1111111111111111111111111111111111111111_____
2   _____________________________________________________________________111111111111111111111111111___________________1111111111111111111111111111111111111111_____
3   _____________________________________________________________________111111111111111111111111111___________________1111111111111111111111111111111111111111_____
4   _____________________________________________________________________111111111111111111111111111___________________1111111111111111111111111111111111111111_____
5   _____________________________________________________________________111111111111111111111111111___________________1111111111111111111111111111111111111111_____
6   _____________________________________________________________________111111111111111111111111111___________________1111111111111111111111111111111111111111_____
7   _____________________________________________________________________111111111111111111111111111___________________1111111111111111111111111111111111111111_____
8   _____________________________________________________________________111111111111111111111111111___________________1111111111111111111111111111111111111111_____
9   _____________________________________________________________________111111111111111111111111111___________________1111111111111111111111111111111111111111_____
10  _____________________________________________________________________111111111111111111111111111___________________1111111111111111111111111111111111111111_____
11  _____________________________________________________________________111111111111111111111111111___________________1111111111111111111111111111111111111111_____
12  _____________________________________________________________________111111111111111111111111111___________________1111111111111111111111111111111111111111_____
13  _____________________________________________________________________111111111111111111111111111___________________1111111111111111111111111111111111111111_____
14  _____________________________________________________________________111111111111111111111111111___________________1111111111111111111111111111111111111111_____
15  _____________________________________________________________________111111111111111111111111111___________________1111111111111111111111111111111111111111_____
16  _____________________________________________________________________111111111111111111111111111___________________1111111111111111111111111111111111111111_____
17  _____________________________________________________________________111111111111111111111111111___________________1111111111111111111111111111111111111111_____
18  _____________________________________________________________________111111111111111111111111111___________________1111111111111111111111111111111111111111_____
19  _____________________________________________________________________111111111111111111111111111___________________1111111111111111111111111111111111111111_____
20  _____________________________________________________________________111111111111111111111111111___________________1111111111111111111111111111111111111111_____
21  _____________________________________________________________________111111111111111111111111111___________________1111111111111111111111111111111111111111_____
22  _____________________________________________________________________111111111111111111111111111___________________1111111111111111111111111111111111111111_____
23  _____________________________________________________________________111111111111111111111111111___________________1111111111111111111111111111111111111111_____
24  _____________________________________________________________________111111111111111111111111111___________________1111111111111111111111111111111111111111_____
25  _____________________________________________________________________111111111111111111111111111___________________1111111111111111111111111111111111111111_____
26  _____________________________________________________________________111111111111111111111111111___________________1111111111111111111111111111111111111111_____
27  _____________________________________________________________________111111111111111111111111111___________________1111111111111111111111111111111111111111_____
28  _____________________________________________________________________111111111111111111111111111___________________1111111111111111111111111111111111111111_____
29  _____________________________________________________________________111111111111111111111111111___________________1111111111111111111111111111111111111111_____
30  _____________________________________________________________________111111111111111111111111111___________________1111111111111111111111111111111111111111_____
31  _____________________________________________________________________111111111111111111111111111___________________1111111111111111111111111111111111111111_____
32  _____________________________________________________________________111111111111111111111111111___________________1111111111111111111111111111111111111111_____
33  _____________________________________________________________________111111111111111111111111111___________________1111111111111111111111111111111111111111_____
34  _____________________________________________________________________111111111111111111111111111___________________1111111111111111111111111111111111111111_____
35  _____________________________________________________________________111111111111111111111111111___________________1111111111111111111111111111111111111111_____
36  _____________________________________________________________________111111111111111111111111111___________________1111111111111111111111111111111111111111_____
37  _____________________________________________________________________111111111111111111111111111___________________1111111111111111111111111111111111111111_____
38  _____________________________________________________________________111111111111111111111111111___________________1111111111111111111111111111111111111111_____
39  _____________________________________________________________________111111111111111111111111111___________________1111111111111111111111111111111111111111_____
40  _____________________________________________________________________111111111111111111111111111___________________1111111111111111111111111111111111111111_____
41  _____________________________________________________________________111111111111111111111111111___________________1111111111111111111111111111111111111111_____
42  _________________________________________________________________________11111111111111111111______________________1111111111111111111111111111111111111111_____
43  _________________________________________________________________________________111111____________________________________11111111111111111111111111111111_____
44  ________________________________________________________________________________________________________________________________________________________________
45  ________________________________________________________________________________________________________________________________________________________________
46  ________________________________________________________________________________________________________________________________________________________________
47  ________________________________________________________________________________________________________________________________________________________________
48  ________________________________________________________________________________________________________________________________________________________________
49  ________________________________________________________________________________________________________________________________________________________________
50  ________________________________________________________________________________________________________________________________________________________________
51  ________________________________________________________________________________________________________________________________________________________________
52  ________________________________________________________________________________________________________________________________________________________________
53  ________________________________________________________________________________________________________________________________________________________________
54  ________________________________________________________________________________________________________________________________________________________________
55  ________________________________________________________________________________________________________________________________________________________________
56  ________________________________________________________________________________________________________________________________________________________________
57  ________________________________________________________________________________________________________________________________________________________________
58  ________________________________________________________________________________________________________________________________________________________________
59  ________________________________________________________________________________________________________________________________________________________________
60  ________________________________________________________________________________________________________________________________________________________________
61  ________________________________________________________________________________________________________________________________________________________________
62  ________________________________________________________________________________________________________________________________________________________________
63  ________________________________________________________________________________________________________________________________________________________________
64  ________________________________________________________________________________________________________________________________________________________________
65  ________________________________________________________________________________________________________________________________________________________________
66  ________________________________________________________________________________________________________________________________________________________________
67  ________________________________________________________________________________________________________________________________________________________________
68  ________________________________________________________________________________________________________________________________________________________________
69  ________________________________________________________________________________________________________________________________________________________________
70  ________________________________________________________________________________________________________________________________________________________________
71  ________________________________________________________________________________________________________________________________________________________________
72  ________________________________________________________________________________________________________________________________________________________________
73  ________________________________________________________________________________________________________________________________________________________________
74  ________________________________________________________________________________________________________________________________________________________________
75  ________________________________________________________________________________________________________________________________________________________________
76  ________________________________________________________________________________________________________________________________________________________________
77  ________________________________________________________________________________________________________________________________________________________________
78  ________________________________________________________________________________________________________________________________________________________________
79  ________________________________________________________________________________________________________________________________________________________________
80  ________________________________________________________________________________________________________________________________________________________________
81  ________________________________________________________________________________________________________________________________________________________________
82  ________________________________________________________________________________________________________________________________________________________________
83  ________________________________________________________________________________________________________________________________________________________________
84  ________________________________________________________________________________________________________________________________________________________________
85  ________________________________________________________________________________________________________________________________________________________________
86  ________________________________________________________________________________________________________________________________________________________________
87  ________________________________________________________________________________________________________________________________________________________________
88  ________________________________________________________________________________________________________________________________________________________________
89  ________________________________________________________________________________________________________________________________________________________________
90  ________________________________________________________________________________________________________________________________________________________________
91  ________________________________________________________________________________________________________________________________________________________________
92  ________________________________________________________________________________________________________________________________________________________________
93  ________________________________________________________________________________________________________________________________________________________________
94  ________________________________________________________________________________________________________________________________________________________________
95  __________________________________________________________________________1111111________11111__________________________________________________________________
96  ____________________________________________________________________________________________________11111_______________________________________________________
97  ________________________________________________________________________________________________________________________________________________________________
98  ________________________________________________________________________________________________________________________________________________________________
99  ________________________________________________________________________________________________________________________________________________________________
100 ________________________________________________________________________________________________________________________________________________________________
101 ____________________1111________________________________________________________________________________________________________________________________________
102 _______________111111111111_____________________________________________________________________________________________________________________________________
103 _________11111111___1___1__111__________________________________________________________________________________________________________________________________
104 ____11111___1___1___1___1___1_11________________________________________________________________________________________________________________________________
105 _1111___1___1___1___1___1___1___111_____________________________________________________________________________________________________________________________
106 ____1___1___1___1___1___1___1______111__________________________________________________________________________________________________________________________
107 ____1___1___1___1___1___1___1_________11________________________________________________________________________________________________________________________
108 ____1___1___1___1___1___1___1________11_________________________________________________________________________________________________________________________
109 ____1___1___1___1___1___1___1______11___________________________________________________________________________________________________________________________
110 ____1___1___1___1___1___1___1___111_____________________________________________________________________________________________________________________________
111 ____1___1___1___1___1___11111111________________________________________________________________________________________________________________________________
112 _111111111111___1111111111______________________________________________________________________________________________________________________________________
113 __________1111111111____________________________________________________________________________________________________________________________________________
114 ________________________________________________________________________________________________________________________________________________________________
115 ________________________________________________________________________________________________________________________________________________________________
116 ________________________________________________________________________________________________________________________________________________________________
117 ________________________________________________________________________________________________________________________________________________________________
118 ________________________________________________________________________________________________________________________________________________________________
119 ________________________________________________________________________________________________________________________________________________________________
120 ________________________________________________________________________________________________________________________________________________________________
121 ________________________________________________________________________________________________________________________________________________________________
122 ________________________________________________________________________________________________________________________________________________________________
123 ________________________________________________________________________________________________________________________________________________________________
124 ________________________________________________________________________________________________________________________________________________________________
125 ________________________________________________________________________________________________________________________________________________________________
126 ________________________________________________________________________________________________________________________________________________________________
127 ________________________________________________________________________________________________________________________________________________________________
128 ________________________________________________________________________________________________________________________________________________________________
129 ________________________________________________________________________________________________________________________________________________________________
130 ________________________________________________________________________________________________________________________________________________________________
131 ________________________________________________________________________________________________________________________________________________________________
132 ________________________________________________________________________________________________________________________________________________________________
133 ________________________________________________________________________________________________________________________________________________________________
134 ________________________________________________________________________________________________________________________________________________________________
135 ________________________________________________________________________________________________________________________________________________________________
136 ________________________________________________________________________________________________________________________________________________________________
137 ________________________________________________________________________________________________________________________________________________________________
138 ________________________________________________________________________________________________________________________________________________________________
139 ________________________________________________________________________________________________________________________________________________________________
140 __________________111111111111111111____________________________________________________________________________________________________________________________
141 ______________1111__________________1___________________________________________________________________________________________________________________________
142 ____________11_______________________1__________________________________________________________________________________________________________________________
143 ____________111_____111111111111111111__________________________________________________________________________________________________________________________
144 _______________11111____________________________________________________________________________________________________________________________________________
145 ________________________________________________________________________________________________________________________________________________________________
146 ________________________________________________________________________________________________________________________________________________________________
147 ________________________________________________________________________________________________________________________________________________________________
148 ________________________________________________________________________________________________________________________________________________________________
149 ________________________________________________________________________________________________________________________________________________________________
150 ________________________________________________________________________________________________________________________________________________________________
151 ________________________________________________________________________________________________________________________________________________________________
152 ________________________________________________________________________________________________________________________________________________________________
153 ________________________________________________________________________________________________________________________________________________________________
154 ________________________________________________________________________________________________________________________________________________________________
155 ________________________________________________________________________________________________________________________________________________________________
156 ________________________________________________________________________________________________________________________________________________________________
157 ________________________________________________________________________________________________________________________________________________________________
158 ________________________________________________________________________________________________________________________________________________________________
159 ________________________________________________________________________________________________________________________________________________________________
160 ________________________________________________________________________________________________________________________________________________________________
161 ________________________________________________________________________________________________________________________________________________________________
162 ________________________________________________________________________________________________________________________________________________________________
163 ________________________________________________________________________________________________________________________________________________________________
164 ________________________________________________________________________________________________________________________________________________________________
165 ________________________________________________________________________________________________________________________________________________________________
166 ________________________________________________________________________________________________________________________________________________________________
167 ________________________________________________________________________________________________________________________________________________________________
