    0         10        20        30        40        50        60        70        80        90        100       110       120       130       140       150       
    0123456789012345678901234567890123456789012345678901234567890123456789012345678901234567890123456789012345678901234567890123456789012345678901234567890123456789
0   ________________________________________________________________________________________________________________________________________________________________
1   ________________________________________________________________________________________________________________________________________________________________
2   ________________________________________________________________________________________________________________________________________________________________
3   ________________________________________________________________________________________________________________________________________________________________
4   ________________________________________________________________________________________________________________________________________________________________
5   ________________________________________________________________________________________________________________________________________________________________
6   ________________________________________________________________________________________________________________________________________________________________
7   ________________________________________________________________________________________________________________________________________________________________
8   ________________________________________________________________________________________________________________________________________________________________
9   ________________________________________________________________________________________________________________________________________________________________
10  ________________________________________________________________________________________________________________________________________________________________
11  ________________________________________________________________________________________________________________________________________________________________
12  ________________________________________________________________________________________________________________________________________________________________
13  ________________________________________________________________________________________________________________________________________________________________
14  ________________________________________________________________________________________________________________________________________________________________
15  ________________________________________________________________________________________________________________________________________________________________
16  ________________________________________________________________________________________________________________________________________________________________
17  ________________________________________________________________________________________________________________________________________________________________
18  ________________________________________________________________________________________________________________________________________________________________
19  ________________________________________________________________________________________________________________________________________________________________
20  ________________________________________________________________________________________________________________________________________________________________
21  ________________________________________________________________________________________________________________________________________________________________
22  ________________________________________________________________________________________________________________________________________________________________
23  ________________________________________________________________________________________________________________________________________________________________
24  ________________________________________________________________________________________________________________________________________________________________
25  ________________________________________________________________________________________________________________________________________________________________
26  ________________________________________________________________________________________________________________________________________________________________
27  ________________________________________________________________________________________________________________________________________________________________
28  ________________________________________________________________________________________________________________________________________________________________
29  ________________________________________________________________________________________________________________________________________________________________
30  ________________________________________________________________________________________________________________________________________________________________
31  ________________________________________________________________________________________________________________________________________________________________
32  ________________________________________________________________________________________________________________________________________________________________
33  ________________________________________________________________________________________________________________________________________________________________
34  ________________________________________________________________________________________________________________________________________________________________
35  ________________________________________________________________________________________________________________________________________________________________
36  ________________________________________________________________________________________________________________________________________________________________
37  ________________________________________________________________________________________________________________________________________________________________
38  ________________________________________________________________________________________________________________________________________________________________
39  ________________________________________________________________________________________________________________________________________________________________
40  ________________________________________________________________________________________________________________________________________________________________
41  ________________________________________________________________________________________________________________________________________________________________
42  ________________________________________________________________________________________________________________________________________________________________
43  ________________________________________________________________________________________________________________________________________________________________
44  ________________________________________________________________________________________________________________________________________________________________
45  ________________________________________________________________________________________________________________________________________________________________
46  ________________________________________________________________________________________________________________________________________________________________
47  ________________________________________________________________________________________________________________________________________________________________
48  ________________________________________________________________________________________________________________________________________________________________
49  ________________________________________________________________________________________________________________________________________________________________
50  ________________________________________________________________________________________________________________________________________________________________
51  ________________________________________________________________________________________________________________________________________________________________
52  ________________________________________________________________________________________________________________________________________________________________
53  ________________________________________________________________________________________________________________________________________________________________
54  ________________________________________________________________________________________________________________________________________________________________
55  ________________________________________________________________________________________________________________________________________________________________
56  ________________________________________________________________________________________________________________________________________________________________
57  ________________________________________________________________________________________________________________________________________________________________
58  ________________________________________________________________________________________________________________________________________________________________
59  ________________________________________________________________________________________________________________________________________________________________
60  ________________________________________________________________________________________________________________________________________________________________
61  ________________________________________________________________________________________________________________________________________________________________
62  ________________________________________________________________________________________________________________________________________________________________
63  ________________________________________________________________________________________________________________________________________________________________
64  ________________________________________________________________________________________________________________________________________________________________
65  ________________________________________________________________________________________________________________________________________________________________
66  ________________________________________________________________________________________________________________________________________________________________
67  ________________________________________________________________________________________________________________________________________________________________
68  ________________________________________________________________________________________________________________________________________________________________
69  ________________________________________________________________________________________________________________________________________________________________
70  ________________________________________________________________________________________________________________________________________________________________
71  ________________________________________________________________________________________________________________________________________________________________
72  _______________________________________________________________11111111111111111111111111111111111______________________________________________________________
73  _______________________________________________________________1_________________________________1______________________________________________________________
74  _______________________________________________________________1_________________________________1______________________________________________________________
75  ______________________________________________________________1__________________________________1______________________________________________________________
76  ______________________________________________________________1__________________________________1______________________________________________________________
77  ______________________________________________________________1__________________________________1______________________________________________________________
78  ______________________________________________________________1__________________________________1______________________________________________________________
79  ______________________________________________________________1__________________________________1______________________________________________________________
80  ______________________________________________________________1__________________________________1______________________________________________________________
81  _____________________________________________________________1___________________________________1______________________________________________________________
82  _____________________________________________________________1___________________________________1______________________________________________________________
83  _____________________________________________________________1___________________________________1______________________________________________________________
84  _____________________________________________________________1111111111111111111111111111111111111______________________________________________________________
85  ________________________________________________________________________________________________________________________________________________________________
86  ________________________________________________________________________________________________________________________________________________________________
87  ________________________________________________________________________________________________________________________________________________________________
88  ____________________________1111111111111111111111111111111111111111111111111111111111111111111111____11111111111111111111111111111111111111111111______________
89  ____________________________1_____________________________________________________________________1__1____________________________________________1_____________
90  ____________________________1_____________________________________________________________________1_1_____________________________________________1_____________
91  ___________________________1_______________________________________________________________________________________________________________________1____________
92  ___________________________1_______________________________________________________________________________________________________________________1____________
93  ___________________________1________________________________________________________________________________________________________________________1___________
94  ___________________________1________________________________________________________________________________________________________________________1___________
95  ___________________________1_________________________________________________________________________________________________________________________1__________
96  __________________________1__________________________________________________________________________________________________________________________1__________
97  __________________________1___________________________________________________________________________________________________________________________1_________
98  __________________________1___________________________________________________________________________________________________________________________1_________
99  __________________________1____________________________________________________________________________________________________________________________1________
100 __________________________1____________________________________________________________________________________________________________________________1________
101 _________________________1______________________________________________________________________________________________________________________________1_______
102 _________________________1______________________________________________________________________________________________________________________________1_______
103 _________________________1_______________________________________________________________________________________________________________________________1______
104 _________________________1_______________________________________________________________________________________________________________________________1______
105 _________________________1________________________________________________________________________________________________________________________________1_____
106 ________________________1_________________________________________________________________________________________________________________________________1_____
107 ________________________1__________________________________________________________________________________________________________________________________1____
108 ________________________1111111________________________________________________________________________1111111_____________________________________________1____
109 ______________________________1_______________________________________________________________________1______1______________________________________________1___
110 _____________________________1________________________________________________________________________1______1______________________________________________1___
111 _____________________________1________________________________________________________________________1______1_______________________________________________1__
112 ____________________________1_________________________________________________________________________1______1_______________________________________________1__
113 ____________________________1_________________________________________________________________________1______1________________________________________________1_
114 ___________________________1__________________________________________________________________________1______1________________________________________________1_
115 ___________________________1__________________________________________________________________________1______1________________________________________________1_
116 __________________________1___________________________________________________________________________1______1________________________________________________1_
117 __________________________1____________________________________________________________________________1_____1________________________________________________1_
118 _________________________1_______________________________________11111111111___________________________1_____1________________________________________________1_
119 _________________________1__________________________________11111___________111________________________1_____1________________________________________________1_
120 ________________________1_________________________________11___________________111_____________________1_____1________________________________________________1_
121 ________________________1_______________________________11________________________11___________________1_____1________________________________________________1_
122 ________________________1______________________________1____________________________1__________________1_____11111111111111111111111111111____________________1_
123 _______________________1_______________________________1____________________________1__________________1__________________________________1___________________1_
124 _______________________1______________________________1______________________________1_________________1__________________________________1___________________1_
125 ______________________1_______________________________1_______________________________1_________________1__________________________________1__________________1_
126 ______________________1_______________________________1_______________________________1_________________1__________________________________1__________________1_
127 _____________________1________________________________1________________________________1________________1___________________________________1_________________1_
128 _____________________1_______________________________1_________________________________1________________1____________________________________1________________1_
129 ____________________1________________________________1_________________________________1________________1____________________________________1________________1_
130 ____________________1________________________________1__________________________________1_______________1_____________________________________1_______________1_
131 ___________________1_________________________________1__________________________________1_______________1_____________________________________1_______________1_
132 ___________________1_________________________________1__________________________________1________________1_____________________________________1______________1_
133 __________________1___________________________________1_________________________________1________________1_____________________________________1______________1_
134 __________________1____________________________________1______________________________11_________________1_____________________________________1______________1_
135 _________________1______________________________________11__________________________11___________________1____1111111111111111111111111111111111______________1_
136 __________11111111________________________________________111____________________111_____________________1____1_______________________________________________1_
137 __________1__________________________________________________111_____________1111________________________1____1_______________________________________________1_
138 _________1______________________________________________________1111111111111____________________________1____1_______________________________________________1_
139 _________1_______________________________________________________________________________________________1____1_______________________________________________1_
140 ________1_________________________________________________________________________________________________1___1_______________________________________________1_
141 ________1_________________________________________________________________________________________________1___1_______________________________________________1_
142 _______1__________________________________________________________________________________________________1___1_______________________________________________1_
143 _______1__________________________________________________________________________________________________1___1_______________________________________________1_
144 ______1___________________________________________________________________________________________________1___1_______________________________________________1_
145 ______1___________________________________________________________________________________________________1___1111111111111111111_____________________________1_
146 _____1____________________________________________________________________________________________________1_____________________1_____________________________1_
147 _____1____________________________________________________________________________________________________1______________________1____________________________1_
148 ____1______________________________________________________________________________________________________1_____________________1____________________________1_
149 ____1______________________________________________________________________________________________________1_____________________1____________________________1_
150 ___1_______________________________________________________________________________________________________1______________________1___________________________1_
151 ___1_______________________________________________________________________________________________________1______________________1___________________________1_
152 __1________________________________________________________________________________________________________1_______________________1__________________________1_
153 __1________________________________________________________________________________________________________1_______________________1__________________________1_
154 _1_________________________________________________________________________________________________________1_______________________1__________________________1_
155 _1__________________________________________________________________________________________________________1_______________________1_________________________1_
156 _1__________________________________________________________________________________________________________1_______________________1_________________________1_
157 _1__________________________________________________________________________________________________________1_______________________1_________________________1_
158 _1__________________________________________________________________________________________________________1_______________________1_________________________1_
159 _1__________________________________________________________________________________________________________1____11111111111111111111_________________________1_
160 _1__________________________________________________________________________________________________________1____1____________________________________________1_
161 _1__________________________________________________________________________________________________________1____1____________________________________________1_
162 _1__________________________________________________________________________________________________________1____1____________________________________________1_
163 _1___________________________________________________________________________________________________________1___1____________________________________________1_
164 _1___________________________________________________________________________________________________________1___1____________________________________________1_
165 _1___________________________________________________________________________________________________________1___1____________________________________________1_
166 _11111111111111111111111111111111111111_______________________111111111111111111111111111111111111111111111111___1111111111111111111111111111111111111111111111_
167 ______________________________________1_______________________1______________________________________________1__________________________________________________
