    0         10        20        30        40        50        60        70        80        90        100       110       120       130       140       150       
    0123456789012345678901234567890123456789012345678901234567890123456789012345678901234567890123456789012345678901234567890123456789012345678901234567890123456789
0   ________________________________________________________________________________________________________________________________________________________________
1   ________________________________________________________________________________________________________________________________________________________________
2   ________________________________________________________________________________________________________________________________________________________________
3   ________________________________________________________________________________________________________________________________________________________________
4   ________________________________________________________________________________________________________________________________________________________________
5   ________________________________________________________________________________________________________________________________________________________________
6   ________________________________________________________________________________________________________________________________________________________________
7   ________________________________________________________________________________________________________________________________________________________________
8   ________________________________________________________________________________________________________________________________________________________________
9   ________________________________________________________________________________________________________________________________________________________________
10  ________________________________________________________________________________________________________________________________________________________________
11  ________________________________________________________________________________________________________________________________________________________________
12  ________________________________________________________________________________________________________________________________________________________________
13  ________________________________________________________________________________________________________________________________________________________________
14  ________________________________________________________________________________________________________________________________________________________________
15  ____________1___11111___________________________________________________________________________________________________________________________________________
16  ____________1___1___1___11111_________________________________________________________________________________________________________________________________1_
17  ____________1___1___1___1___1___1__________________________________________________________________________________________________1__11111___11111___11111___1_
18  _______1____1___1___1___1___1___1_______________________________________________________________________________________________1__1__1___1___1___1___1___1___1_
19  _______1____1___1___1___1___1___1_______________________________________________________________________________________________1__1__1___1___1___1___1___1___1_
20  _______1____1___1___1___1___1___1_______________________________________________________________________________________________1__1__1___1___1___1___1___1___1_
21  _______1____1___1___1___1___1___1_______________________________________________________________________________________________1__1__1___1___1___1___1___1___1_
22  _______1____1___1___1___1___1___1_______________________________________________________________________________________________1__1__1___1___1___1___1___1___1_
23  _______1____1___1___1___1___1___1_______________________________________________________________________________________________1__1__1___1___1___1___1___1___1_
24  _______1____1___1___1___1___1___1_______________________________________________________________________________________________1__1__1___1___1___1___1___1___1_
25  _______1____1___1___1___1___1___1_______________________________________________________________________________________________1__1__1___1___1___1___1___1___1_
26  ________1___1___1___1___1___1___1_______________________________________________________________________________________________1__1__1___1___1___1___1___1___1_
27  ________1___1___1___1___1___1___1_______________________________________________________________________________________________1__1__1___1___1___1___1___1___1_
28  ________1___1___1___1___1___1___1_______________________________________________________________________________________________1__1__1___1___1___1___1___1___1_
29  ________1___1___1___1___1___1___1_______________________________________________________________________________________________1__1__1___1___1___1___1___1___1_
30  ________1___1___1___1___1___1___1_______________________________________________________________________________________________1__1__1___1___1___1___1___1___1_
31  ________1___1___1___1___1___1___1_______________________________________________________________________________________________1__1__1___1___1___1___1___1___1_
32  ________1___1___1___1___1___1___1_______________________________________________________________________________________________1__1__1___1___1___1___1___1___1_
33  ________1___1___1___1___1___1___1_______________________________________________________________________________________________1__1__1___1___1___1___1___1___1_
34  ________1___1___1___1___1___1___1_______________________________________________________________________________________________1__1__1___1___1___1___1___1___1_
35  ________1___1___1___1___1___1___1_______________________________________________________________________________________________1__1__1___1___1___1___1___1___1_
36  ________1___1___1___1___1___1___1_______________________________________________________________________________________________1__1__1___1___1___1___1___1___1_
37  ________1___1___1___1___1___1__11_______________________________________________________________________________________________1__1__1___1___1___1___1___1___1_
38  _________1__1___1___1___1___111_________________________________________________________________________________________________1__1__1___1___1___1___1___1___1_
39  _________1__1___1___1___1__11___________________________________________________________________________________________________1__1__1___1___1___111111111___1_
40  _________1__1___1___1___111_____________________________________________________________________________________________________1__1__1___1___1_1111______11111_
41  _________1__1___1___11111_______________________________________________________________________________________________________1__1__1___111111________________
42  _________11111111___11__________________________________________________________________________________________________________1111111__1111___________________
43  ______________111111________________________________________________________________________________________________________________11111_______________________
44  ________________________________________________________________________________________________________________________________________________________________
45  ________________________________________________________________________________________________________________________________________________________________
46  ________________________________________________________________________________________________________________________________________________________________
47  ________________________________________________________________________________________________________________________________________________________________
48  ________________________________________________________________________________________________________________________________________________________________
49  ________________________________________________________________________________________________________________________________________________________________
50  ________________________________________________________________________________________________________________________________________________________________
51  ________________________________________________________________________________________________________________________________________________________________
52  ________________________________________________________________________________________________________________________________________________________________
53  ________________________________________________________________________________________________________________________________________________________________
54  ________________________________________________________________________________________________________________________________________________________________
55  ________________________________________________________________________________________________________________________________________________________________
56  ________________________________________________________________________________________________________________________________________________________________
57  ________________________________________________________________________________________________________________________________________________________________
58  ______________________________________________________________________________________________________________1_________________________________________________
59  ____________________________________________________________________________________________________________11_11_______________________________________________
60  __________________________________________________________________________________________________________11_____11_____________________________________________
61  ________________________________________________________________________________________________________11_________1____________________________________________
62  _______________________________________________________________________________________________________1______1111__11__________________________________________
63  ________________________________________________________________________________________________________1_____1___11111_________________________________________
64  ________________________________________________________________________________________________________1___11__________________________________________________
65  _________________________________________________________________________________________________________111____________________________________________________
66  _________________________________________________________________________________________________________1______________________________________________________
67  ________________________________________________________________________________________________________________________________________________________________
68  ________________________________________________________________________________________________________________________________________________________________
69  ________________________________________________________________________________________________________________________________________________________________
70  ________________________________________________________________________________________________________________________________________________________________
71  ________________________________________________________________________________________________________________________________________________________________
72  ________________________________________________________________________________________________________________________________________________________________
73  ________________________________________________________________________________________________________________________________________________________________
74  ________________________________________________________________________________________________________________________________________________________________
75  ________________________________________________________________________________________________________________________________________________________________
76  ________________________________________________________________________________________________________________________________________________________________
77  ________________________________________________________________________________________________________________________________________________________________
78  ________________________________________________________________________________________________________________________________________________________________
79  ________________________________________________________________________________________________________________________________________________________________
80  ________________________________________________________________________________________________________________________________________________________________
81  ________________________________________________________________________________________________________________________________________________________________
82  ________________________________________________________________________________________________________________________________________________________________
83  ________________________________________________________________________________________________________________________________________________________________
84  ________________________________________________________________________________________________________________________________________________________________
85  ________________________________________________________________________________________________________________________________________________________________
86  ________________________________________________________________________________________________________________________________________________________________
87  ________________________________________________________________________________________________________________________________________________________________
88  ________________________________________________________________________________________________________________________________________________________________
89  ________________________________________________________________________________________________________________________________________________________________
90  ________________________________________________________________________________________________________________________________________________________________
91  _________________________________________________________________________________________________________________________111111111111111________________________
92  _______________________________________________________________________________________________________________________11__________1____1111____________________
93  _____________________________________________________________________________________________________________________11____________1_____1__111_________________
94  ____________________________________________________________1111111111_____________________________________________11______________1_____1_____1111_____________
95  ______________________________________________11111111111111__________1111_______________________________________11________________1_____1______1__11___________
96  ______________________________1111111111111111__________________________11_____________________________________11__________________1_____1______1___1___________
97  ______________________________1__1111___________________________________11____________________________________1____________________1_____1______1___1___________
98  ______________________________111______________________________________1_1_____________________________________1___________________1_____1______1___1___________
99  ______________________________11______________________________________1__1______________________________________1__________________1_____1______1___1___________
100 ______________________________11______________________________________1__1_______________________________________1_________________1_____1______1___1___________
101 ______________________________1______________________________________11111_______________________________________1_________________1_____1______1__1____________
102 ______________________________1_____________________________________1_____________________________________________1________________1_____1______1_1_____________
103 ______________________________1_____________________________________1______________________________________________1_______________1_____1______11______________
104 ______________________________1__________________________________111________________________________________________11111__________1_____1______11______________
105 ______________________________1_____________________________11111________________________________________________________11111111__1_____1______1_______________
106 _______________________________1_______________________11111_____________________________________________________________________1111111111111111_______________
107 _______________________________1___________________1111_________________________________________________________________________________________________________
108 ________________________________1________________11_____________________________________________________________________________________________________________
109 ________________________________111___________111_______________________________________________________________________________________________________________
110 ___________________________________11111____11__________________________________________________________________________________________________________________
111 ________________________________________1111____________________________________________________________________________________________________________________
112 ________________________________________________________________________________________________________________________________________________________________
113 ________________________________________________________________________________________________________________________________________________________________
114 ________________________________________________________________________________________________________________________________________________________________
115 ________________________________________________________________________________________________________________________________________________________________
116 ________________________________________________________________________________________________________________________________________________________________
117 ________________________________________________________________________________________________________________________________________________________________
118 ________________________________________________________________________________________________________________________________________________________________
119 ________________________________________________________________________________________________________________________________________________________________
120 ____________________________________________________________1111111111111111111_________________________________________________________________________________
121 ____________________________________________________________1___11_______111111_________________________________________________________________________________
122 ____________________________________________________________1_11______________1_________________________________________________________________________________
123 ____________________________________________________________11________________1_________________________________________________________________________________
124 ____________________________________________________________1_______________11__________________________________________________________________________________
125 ____________________________________________________________1111111________1____________________________________________________________________________________
126 ___________________________________________________________________11___111_____________________________________________________________________________________
127 _____________________________________________________________________111________________________________________________________________________________________
128 ________________________________________________________________________________________________________________________________________________________________
129 ________________________________________________________________________________________________________________________________________________________________
130 ________________________________________________________________________________________________________________________________________________________________
131 ________________________________________________________________________________________________________________________________________________________________
132 ________________________________________________________________________________________________________________________________________________________________
133 ________________________________________________________________________________________________________________________________________________________________
134 ________________________________________________________________________________________________________________________________________________________________
135 ________________________________________________________________________________________________________________________________________________________________
136 ________________________________________________________________________________________________________________________________________________________________
137 ________________________________________________________________________________________________________________________________________________________________
138 ________________________________________________________________________________________________________________________________________________________________
139 ________________________________________________________________________________________________________________________________________________________________
140 ________________________________________________________________________________________________________________________________________________________________
141 ________________________________________________________________________________________________________________________________________________________________
142 ________________________________________________________________________________________________________________________________________________________________
143 ________________________________________________________________________________________________________________________________________________________________
144 ________________________________________________________________________________________________________________________________________________________________
145 ________________________________________________________________________________________________________________________________________________________________
146 ________________________________________________________________________________________________________________________________________________________________
147 ________________________________________________________________________________________________________________________________________________________________
148 ________________________________________________________________________________________________________________________________________________________________
149 ________________________________________________________________________________________________________________________________________________________________
150 ________________________________________________________________________________________________________________________________________________________________
151 ________________________________________________________________________________________________________________________________________________________________
152 ________________________________________________________________________________________________________________________________________________________________
153 ________________________________________________________________________________________________________________________________________________________________
154 ________________________________________________________________________________________________________________________________________________________________
155 ________________________________________________________________________________________________________________________________________________________________
156 ________________________________________________________________________________________________________________________________________________________________
157 ________________________________________________________________________________________________________________________________________________________________
158 ________________________________________________________________________________________________________________________________________________________________
159 ________________________________________________________________________________________________________________________________________________________________
160 ________________________________________________________________________________________________________________________________________________________________
161 ________________________________________________________________________________________________________________________________________________________________
162 ________________________________________________________________________________________________________________________________________________________________
163 ________________________________________________________________________________________________________________________________________________________________
164 ________________________________________________________________________________________________________________________________________________________________
165 ________________________________________________________________________________________________________________________________________________________________
166 ________________________________________________________________________________________________________________________________________________________________
167 ________________________________________________________________________________________________________________________________________________________________
