    0         10        20        30        40        50        60        70        80        90        100       110       120       130       140       150       
    0123456789012345678901234567890123456789012345678901234567890123456789012345678901234567890123456789012345678901234567890123456789012345678901234567890123456789
0   ________________________________________________________________________________________________________________________________________________________________
1   ________________________________________________________________________________________________________________________________________________________________
2   ________________________________________________________________________________________________________________________________________________________________
3   ________________________________________________________________________________________________________________________________________________________________
4   ________________________________________________________________________________________________________________________________________________________________
5   ________________________________________________________________________________________________________________________________________________________________
6   ________________________________________________________________________________________________________________________________________________________________
7   ________________________________________________________________________________________________________________________________________________________________
8   ________________________________________________________________________________________________________________________________________________________________
9   ________________________________________________________________________________________________________________________________________________________________
10  ________________________________________________________________________________________________________________________________________________________________
11  ________________________________________________________________________________________________________________________________________________________________
12  ________________________________________________________________________________________________________________________________________________________________
13  ________________________________________________________________________________________________________________________________________________________________
14  ________________________________________________________________________________________________________________________________________________________________
15  ________________________________________________________________________________________________________________________________________________________________
16  ________________________________________________________________________________________________________________________________________________________________
17  ________________________________________________________________________________________________________________________________________________________________
18  ________________________________________________________________________________________________________________________________________________________________
19  ________________________________________________________________________________________________________________________________________________________________
20  ________________________________________________________________________________________________________________________________________________________________
21  ________________________________________________________________________________________________________________________________________________________________
22  ________________________________________________________________________________________________________________________________________________________________
23  ________________________________________________________________________________________________________________________________________________________________
24  ________________________________________________________________________________________________________________________________________________________________
25  ________________________________________________________________________________________________________________________________________________________________
26  ________________________________________________________________________________________________________________________________________________________________
27  ________________________________________________________________________________________________________________________________________________________________
28  ________________________________________________________________________________________________________________________________________________________________
29  ________________________________________________________________________________________________________________________________________________________________
30  ________________________________________________________________________________________________________________________________________________________________
31  ________________________________________________________________________________________________________________________________________________________________
32  ________________________________________________________________________________________________________________________________________________________________
33  ________________________________________________________________________________________________________________________________________________________________
34  ________________________________________________________________________________________________________________________________________________________________
35  ________________________________________________________________________________________________________________________________________________________________
36  ________________________________________________________________________________________________________________________________________________________________
37  ________________________________________________________________________________________________________________________________________________________________
38  ________________________________________________________________________________________________________________________________________________________________
39  ________________________________________________________________________________________________________________________________________________________________
40  _________________________________________________________________________33333__________________________________________________________________________________
41  _________________________________________________________________________333333_________________________________________________________________________________
42  _____________________________________________33333333333333333333333333333333333________________________________________________________________________________
43  ______________________________________333333333333333333333333333333333333333333________________________________________________________________________________
44  __________________________________33333333333333333333333333333333333333333333333_______________________________________________________________________________
45  _________________________________3333333333333333333333333333333333333333333333333______________________________________________________________________________
46  ________________________________333333333333333333333333333333333333333333333333333_____________________________________________________________________________
47  ________________________________333333333333333333333333333333333333333333333333333_____________________________________________________________________________
48  ________________________________333333333333333333333333333333333333333333333333333_____________________________________________________________________________
49  _______________________________33333333333333333333333333333333333333333333333333333____________________________________________________________________________
50  _______________________________333333333333333333333333333333333333333333333333333333___________________________________________________________________________
51  _______________________________333333333333333333333333333333333333333333333333333333___________________________________________________________________________
52  _______________________________3333333333333333333333333333333333333333333333333333333__________________________________________________________________________
53  _______________________________3333333333333333333333333333333333333333333333333333333__________________________________________________________________________
54  ______________________________33333333333333333333333333333333333333333333333333333333__________________________________________________________________________
55  ______________________________33333333333333333333333333333333333333333333333333333333__________________________________________________________________________
56  _______________________________33333333333333333333333333333333333333333333333333333333______111111111__________________________________________________________
57  _______________________________333333333333333333333333333333333333333333333333333333333___111____1___1_________________________________________________________
58  _______________________________33333333333333333333333333333333333333333333333333333333_111__1____1____11_______________________________________________________
59  ______________________________33333333333333333333333333333333333333333333333333333333111____1____1_____11______________________________________________________
60  _______________________________33333333333333333333333333333333333333333333333333333333111___1____1_____11______________________________________________________
61  ______________________________33333333333333333333333333333333333333333333333333333333331113_1____1_11111_______________________________________________________
62  ______________________________3333333333333333333333333333333333333333333333333333333333311111111111____1_______________________________________________________
63  ______________________________333333333333333333333333333333333333333333333333333333333333111111111111111_______________________________________________________
64  ______________________________333333333333333333333333333333333333333333333333333333333333333333333333__________________________________________________________
65  ______________________________3333333333333333333333333333333333333333333333333333333333333333333333333_________________________________________________________
66  ______________________________333333333333333333333333333333333333333333333333333333333333333333333333333_______________________________________________________
67  ______________________________3333333333333333333333333333333333333333333333333333333333333333333333333333______________________________________________________
68  ______________________________333333333333333333333333333333333333333333333333333333333333333333333333333_______________________________________________________
69  ______________________________333333333333333333333333333333333333333333333333333333333333333333333333333_______________________________________________________
70  _________11111111111111111111113333333333333333333333333333333333333333333333333333333333333333333333333________________________________________________________
71  _________1_____1_____1____1___13333333333333333333333333333333333333333333333333333333333333333333333333________________________________________________________
72  _________1_____1_____1____1___13333333333333333333333333333333333333333333333333333333333333333333333331111111111111111111111___________________________________
73  _________1_____1_____1____1___13333333333333333333333333333333333333333333333333333333333333333333333331_____1____1___1_____1___________________________________
74  _________1_____1__11111___1___13333333333333333333333333333333333333333333333333333333333333333333333331_____1____1___1_____1___________________________________
75  _________1___11111___111111___133333333333333333333333333333333333333333333333333333333333333333333333311____1____1___1___111___________________________________
76  _________11111___1___1___1111_1333333333333333333333333333333333333333333333333333333333333333333333333111___1____1___1_11_1____________________________________
77  _________1___1___1___1___1___113333333333333333333333333333333333333333333333333333333333333333333333331311__1____1___11__1_____________________________________
78  _________1___1___1___1___1333313333333333333333333333333333333333333333333333333333333333333333333333333131111____1_111__1______________________________________
79  _________1___1___1___1___1333313333333333333333333333333333333333333333333333333333333333333333333333333313331111111__1_1_______________________________________
80  _________1___1___1___1___13333133333333333333333333333333333333333333333333333333333333333333333333333333313333313313311________________________________________
81  _________1___1___1___1___13333133333333333333333333333333333333333333333333333333333333333333333333333333331111111111113________________________________________
82  _________1___1___11111___1333313333333333333333333333333333333333333333333333333333333333333333333333333333333333333333333______________________________________
83  _________111111111111111111111133333333333333333333333333333333333333333333333333333333333333333333333333333333333333333333_____________________________________
84  ________________________3_3333333333333333333333333333333333333333333333333333333333333333333333333333333333333333333333333_____________________________________
85  ________________________3_33333333333333333333333333333333333333333333333333333333333333333333333333333333333333333333333333____________________________________
86  ________________________3_33333333333333333333333333333333333333333333333333333333333333333333333333333333333333333333333333____________________________________
87  ________________________3_333333333333333333333333333333333333333333333333333333333333333333333333333333333333333333333333333___________________________________
88  ________________________3_333333333333333333333333333333333333333333333333333333333333333333333333333333333333333333333333333___________________________________
89  ________________________3_3333333333333333333333333333333333333333333333333333333333333333333333333333333333333333333333333333__________________________________
90  ________________________3_3333333333333333333333333333333333333333333333333333333333333333333333333333333333333333333333333333__________________________________
91  ________________________3_33333333333333333333333333333333333333333333333333333333333333333333333333333333333333333333333333333_________________________________
92  ________________________3_33333333333333333333333333333333333333333333333333333333333333333333333333333333333333333333333333333_________________________________
93  ________________________3_333333333333333333333333333333333333333333333333333333333333333333333333333333333333333333333333333333________________________________
94  ________________________3_333333333333333333333333333333333333333333333333333333333333333333333333333333333333333333333333333333________________________________
95  ________________________3_333333333333333333333333333333333333333333333333333333333333333333333333333333333333333333333333333333________________________________
96  _______________________33_333333333333333333333333333333333333333333333333333333333333333333333333333333333333333333333333333333________________________________
97  _______________________33_333333333333333333333333333333333333333333333333333333333333333333333333333333333333333333333333333333________________________________
98  _______________________33_333333333333333333333333333333333333333333333333333333333333333333333333333333333333333333333333333333________________________________
99  _______________________33_333333333333333333333333333333333333333333333333333333333333333333333333333333333333333333333333333333________________________________
100 _______________________33_333333333333333333333333333333333333333333333333333333333333333333333333333333333333333333333333333333________________________________
101 _______________________33_333333333333333333333333333333333333333333333333333333333333333333333333333333333333333333333333333333________________________________
102 _______________________33_333333333333333333333333333333333333333333333333333333333333333333333333333333333333333333333333333333________________________________
103 _______________________33_333333333333333333333333333333333333333333333333333333333333333333333333333333333333333333333333333333________________________________
104 _______________________33_333333333333333333333333333333333333333333333333333333333333333333333333333333333333333333333333333333________________________________
105 _______________________33_333333333333333333333333333333333333333333333333333333333333333333333333333333333333333333333333333333________________________________
106 _______________________33_333333333333333333333333333333333333333333333333333333333333333333333333333333333333333333333333333333________________________________
107 _______________________33_333333333333333333333333333333333333333333333333333333333333333333333333333333333333333333333333333333________________________________
108 _______________________33_333333333333333333333333333333333333333333333333333333333333333333333333333333333333333333333333333333________________________________
109 _______________________33_333333333333333333333333333333333333333333333333333333333333333333333333333333333333333333333333333333________________________________
110 ________________________3_333333333333333333333333333333333333333333333333333333333333333333333333333333333333333333333333333333________________________________
111 ________________________3_333333333333333333333333333333333333333333333333333333333333333333333333333333333333333333333333333333________________________________
112 ________________________3_33333333333333333333333333333333333333333333333333333333333333333333333333333333333333333333333333333_________________________________
113 ________________________3_333333333333333333333333333333333333333333333333333333333333333333333333333333333333333333333333_3333_________________________________
114 ________________________3_33333333333333333333333333333333333333333333333333333333333333333333333333333333333333333333333__333__________________________________
115 ________________________3_33333333333333333333333333333333333333333333333333333333333333333333333333333333333333333333333___33__________________________________
116 ________________________3_3333333333333333333333333333333333333333333333333333333333333333333333333333333333333333333333____33__________________________________
117 ________________________3_3333333333333333333333333333333333333333333333333333333333333333333333333333333333333333333333____3___________________________________
118 ________________________3_333333333333333333333333333333333333333333333333333333333333333333333333333333333333333333333_________________________________________
119 ________________________3_333333333333333333333333333333333333333333333333333333333333333333333333333333333333333333333_________________________________________
120 __________________________33333333333333333333333333333333333333333333333333333333333333333333333333333333333333333333__________________________________________
121 __________________________33333333333333333333333333333333333333333333333333333333333333333333333333333333333333333333__________________________________________
122 __________________________3333333333333333333333333333333333333333333333333333333333333333333333333333333333333333333___________________________________________
123 __________________________3333333333333333333333333333333333333333333333333333333333333333333333333333333333333333333___________________________________________
124 __________________________333333333333333333333333333333333333333333333333333333333333333333333333333333333333333333____________________________________________
125 __________________________333333333333333333333333333333333333333333333333333333333333333333333333333333333333333333____________________________________________
126 __________________________333333333333333333333333333333333333333333333333333333333333333333333333333333333333333333____________________________________________
127 __________________________333333333333333333333333333333333333333333333333333333333333333333333333333333333333333333____________________________________________
128 __________________________333333333333333333333333333333333333333333333333333333333333333333333333333333333333333333____________________________________________
129 __________________________333333333333333333333333333333333333333333333333333333333333333333333333333333333333333333____________________________________________
130 __________________________333333333333333333333333333333333333333333333333333333333333333333333333333333333333333333____________________________________________
131 ___________________________3333333333333333333333333333333333333333333333333333333333333333333333333333333333333333_____________________________________________
132 ___________________________3333333333333333333333333333333333333333333333333333333333333333333333333333333333333333_____________________________________________
133 ___________________________3333333333333333333333333333333333333333333333333333333333333333333333333333333333333333_____________________________________________
134 ___________________________3333333333333333333333333333333333333333333333333333333333333333333333333333333333333333_____________________________________________
135 ____________________________33333333333333333333333333333333333333333333333333333333333333333333333333333333333333______________________________________________
136 ____________________________333333333333333333333333333333333333333333333333333333333333333333333333333333333333________________________________________________
137 ____________________________33333333333333333333333333333333333333333333333333333333333333333333333333333333333_______111_______________________________________
138 _____________________________33333333333333333333333333333333333333333333333333333333333333333333333333333333______111___11_____________________________________
139 _____________________________3333333333333333333333333333333333333333333333333333333333333333333333333333333_____11________1111_________________________________
140 _____________________________3333333333333333333333333333333333333333333333333333333333333333333333333333333___11______________111______________________________
141 ______________________________33333333333333333333333333333333333333333333333333333333333333333333333333333____1_________________1______________________________
142 ______________________________33333333333333333333333333333333333333333333333333333333333333333333333333333____1_________________1______________________________
143 _______________________________333333333333333333333333333333333333333333333333333333333333333333333333333_____1111111111111111111______________________________
144 ________________________________33333333333333333333333333333333333333333333333333333333333333333333333333______________________________________________________
145 _________________________________3333333333333333333333333333333333333333333333333333333333333333333333333______________________________________________________
146 _________________________________3333333333333333333333333333333333333333333333333333333333333333333333333______________________________________________________
147 __________________________________33333333333333333333333333333333333333333333333333333333333333333333333_______________________________________________________
148 ___________________________________3333333333333333333333333333333333333333333333333333333333333333333333_______________________________________________________
149 ____________________________________333333333333333333333333333333333333333333333333333333333333333333333_______________________________________________________
150 ______________________________________3333333333333333333333333333333333333333333333333333333333333333333_______________________________________________________
151 _______________________________________333333333333333333333333333333333333333333333333333333333333333333_______________________________________________________
152 _________________________________________333333333333333333333333333333333333333333333333333333333333333________________________________________________________
153 __________________________________________33333333333333333333333333333333333333333333333333333333333333________________________________________________________
154 ___________________________________________3333333333333333333333333333333333333333333333333333333333333________________________________________________________
155 _____________________________________________33333333333333333333333333333333333333333333333333333333333________________________________________________________
156 ______________________________________________3333333333333333333333333333333333333333333333333333333333________________________________________________________
157 ________________________________________________3333333333333333333333333333333333333333333333333333333_________________________________________________________
158 _________________________________________________333333333333333333333333333333333333333333333333333333_________________________________________________________
159 _________________________________________________33333333333333333333333333333333333333333333333333333__________________________________________________________
160 __________________________________________________3333333333333333333333333333333333333333333333333333__________________________________________________________
161 __________________________________________________333333333333333333333333333333333333333333333333333___________________________________________________________
162 ___________________________________________________3333333333333333333333333333333333333333333333333____________________________________________________________
163 ___________________________________________________333333333333333333333333333333333333333333333333_____________________________________________________________
164 _____________________________________________________333333333333333333333333333333333333333333333______________________________________________________________
165 ______________________________________________________3333333333333333333333333333333333333333333_______________________________________________________________
166 ________________________________________________________3333333333333333333333333333333333333333________________________________________________________________
167 ________________________________________________________333333333333333333333333333333333333333333______________________________________________________________
