    0         10        20        30        40        50        60        70        80        90        100       110       120       130       140       150       
    0123456789012345678901234567890123456789012345678901234567890123456789012345678901234567890123456789012345678901234567890123456789012345678901234567890123456789
0   ________________________________________________________________________________________________________________________________________________________________
1   ________________________________________________________________________________________________________________________________________________________________
2   ________________________________________________________________________________________________________________________________________________________________
3   ________________________________________________________________________________________________________________________________________________________________
4   ________________________________________________________________________________________________________________________________________________________________
5   ________________________________________________________________________________________________________________________________________________________________
6   ________________________________________________________________________________________________________________________________________________________________
7   ________________________________________________________________________________________________________________________________________________________________
8   ________________________________________________________________________________________________________________________________________________________________
9   ________________________________________________________________________________________________________________________________________________________________
10  ________________________________________________________________________________________________________________________________________________________________
11  ________________________________________________________________________________________________________________________________________________________________
12  ________________________________________________________________________________________________________________________________________________________________
13  ________________________________________________________________________________________________________________________________________________________________
14  ________________________________________________________________________________________________________________________________________________________________
15  ________________________________________________________________________________________________________________________________________________________________
16  ________________________________________________________________________________________________________________________________________________________________
17  ________________________________________________________________________________________________________________________________________________________________
18  ________________________________________________________________________________________________________________________________________________________________
19  ________________________________________________________________________________________________________________________________________________________________
20  ________________________________________________________________________________________________________________________________________________________________
21  ________________________________________________________________________________________________________________________________________________________________
22  ________________________________________________________________________________________________________________________________________________________________
23  ________________________________________________________________________________________________________________________________________________________________
24  ________________________________________________________________________________________________________________________________________________________________
25  ________________________________________________________________________________________________________________________________________________________________
26  ________________________________________________________________________________________________________________________________________________________________
27  ________________________________________________________________________________________________________________________________________________________________
28  ________________________________________________________________________________________________________________________________________________________________
29  ________________________________________________________________________________________________________________________________________________________________
30  ________________________________________________________________________________________________________________________________________________________________
31  ____________________________________________________________3333333____33_______________________________________________________________________________________
32  _______________________________________________________333333333333____333______________________________________________________________________________________
33  _______________________________________________________33331333333333333333_____________________________________________________________________________________
34  _____________________________________________________3333331333333333333333_____________________________________________________________________________________
35  ____________________________________________________333333313333333333333333____________________________________________________________________________________
36  ___________________________________________________33333333133333333333333333___________________________________________________________________________________
37  ____________________________________________________333333313333333333333333333_________________________________________________________________________________
38  _____________________________________________________333333133333333333333313333________________________________________________________________________________
39  ____________________________________________________3333333133333333333333313333________________________________________________________________________________
40  ___________________________________________________33333333133333333333333313333________________________________________________________________________________
41  ________________________________________________33333313333333333333333333313333________________________________________________________________________________
42  ______________________________________________33333333133333333333333333333133333_______________________________________________________________________________
43  ____________________________________________3333333333133333333333333333333133333_______________________________________________________________________________
44  ___________________________________________333331333331333333333333333333331333333______________________________________________________________________________
45  _111111111111111111_______________________3333331333331333333333333333333331113333______________________________________________________________________________
46  ___1___1___1___1___1111___________________3333331333331333333333333333333333313333______________________________________________________________________________
47  ___1___1___1___1_______11_________________3333331333331333333333333333333333313333______________________________________________________________________________
48  ___1___1111111111111____1________________33333331333331333333333333333333333313333______________________________________________________________________________
49  _111111_____________11__1_________33___33333333313333313333333333333333333333133333_____________________________________________________________________________
50  ______________________11________333333333313333313333313333333333333333333333133333_____________________________________________________________________________
51  ________________________________3333333333133333133333133333333333333333333331333333____________________________________________________________________________
52  _______________________________33333333333133333133333133333333333333333333331333333____________________________________________________________________________
53  _______________________________33333133333133333133333133333333333333333333331333333_____________________________________111111111111111111_____________________
54  __________________________3____33333133333133333133333333333333333333333333331333333____________________________________1__________________1111_________________
55  __________________________33__333333133333133333133333333333333333333333333331333333__________________________________11______________________1_________________
56  __________________________333333333313333313333313333333333333333333333333333133333__________________________________1________________________1_________________
57  ___________________33______33333333313333313333313333333333333333333333333333133333__________________________________1________________________1_________________
58  _______33______3333333___3333313333313333313333313333333333333333333333333333133333_________________________________1_________________________1_________________
59  _33333333___33333333333333333313333313333313333313333333333333333333333333333333333_________________________________111111111111111111111111111_________________
60  _333313333_3333331333331333333133333133333133333133333333333333333333333333333333_______________________________________________________________________________
61  _333313333333333313333313333331333331333331333331333333333333333333333333333333_________________________________________________________________________________
62  _3333133333133333133333133333313333313333313333333333333333333333333333333333___________________________________________________________________________________
63  _333313333313333313333313333331333331333331333333333333333333333333333333333____________________________________________________________________________________
64  _33331333331333331333331333333133333133333133333333333333333333333333333333_____________________________________________________________________________________
65  _3333133333133333133333133333313333313333313333333333333333333333333333333______________________________________________________________________________________
66  _333313333313333313333313333331333331333331333333333333333333333333333333_______________________________________________________________________________________
67  _333313333313333313333313333331333331333331333333333333333333333333333333_______________________________________________________________________________________
68  _3333133333133333133333133333313333313333313333333333333333333333333333_________________________________________________________________________________________
69  _33331333331333331333331333333133333133333133333333333333333333333333___________________________________________________________________________________________
70  _3333133333133333133333133333313333313333313333333333333333333333333____________________________________________________________________________________________
71  _3333133333133333133333133333313333313333313333333333333333333333333____________________________________________________________________________________________
72  _33331333331333331333331333333133333133333133333333333333333333333______________________________________________________________________________________________
73  _33331333331333331333331333333133333133333333333333333333333____________________________________________________________________________________________________
74  _33331333331333331333331333333133333133333333333333333333_______________________________________________________________________________________________________
75  _33331333331333331333331333333133333133333333333333_____________________________________________________________________________________________________________
76  _333313333313333313333313333331333331333333333333_______________________________________________________________________________________________________________
77  _33331333331333331333331333333133333133333333333________________________________________________________________________________________________________________
78  _33331333331333331111111333333111111133333333333________________________________________________________________________________________________________________
79  _3333111111133333333333333333333333333333333333_________________________________________________________________________________________________________________
80  _333333333333333333333333333333333333333333333__________________________________________________________________________________________________________________
81  _33333333333333333333333333333333333333333333___________________________________________________________________________________________________________________
82  _3333333333333333333333333333333333333333333____________________________________________________________________________________________________________________
83  _333333333333333333333333333333333333333333_____________________________________________________________________________________________________________________
84  _33333333__333333333333333333__33333333333_______11111111111111111______________________________________________________________________________________________
85  _3333333_____333333333333_______33333___3_______111_____________11______________________________________________________________________________________________
86  _33333_________3333333_____________________________111111____111________________________________________________________________________________________________
87  _________________33______________________________________1111___________________________________________________________________________________________________
88  ________________________________________________________________________________________________________________________________________________________________
89  ________________________________________________________________________________________________________________________________________________________________
90  ________________________________________________________________________________________________________________________________________________________________
91  ________________________________________________________________________________________________________________________________________________________________
92  ________________________________________________________________________________________________________________________________________________________________
93  ________________________________________________________________________________________________________________________________________________________________
94  ________________________________________________________________________________________________________________________________________________________________
95  ________________________________________________________________________________________________________________________________________________________________
96  ________________________________________________________________________________________________________________________________________________________________
97  ________________________________________________________________________________________________________________________________________________________________
98  ________________________________________________________________________________________________________________________________________________________________
99  ________________________________________________________________________________________________________________________________________________________________
100 ________________________________________________________________________________________________________________________________________________________________
101 ________________________________________________________________________________________________________________________________________________________________
102 ________________________________________________________________________________________________________________________________________________________________
103 ________________________________________________________________________________________________________________________________________________________________
104 ________________________________________________________________________________________________________________________________________________________________
105 ________________________________________________________________________________________________________________________________________________________________
106 ________________________________________________________________________________________________________________________________________________________________
107 ________________________________________________________________________________________________________________________________________________________________
108 ________________________________________________________________________________________________________________________________________________________________
109 ________________________________________________________________________________________________________________________________________________________________
110 ________________________________________________________________________________________________________________________________________________________________
111 ________________________________________________________________________________________________________________________________________________________________
112 ________________________________________________________________________________________________________________________________________________________________
113 ________________________________________________________________________________________________________________________________________________________________
114 ________________________________________________________________________________________________________________________________________________________________
115 ________________________________________________________________________________________________________________________________________________________________
116 ________________________________________________________________________________________________________________________________________________________________
117 ________________________________________________________________________________________________________________________________________________________________
118 ________________________________________________________________________________________________________________________________________________________________
119 ________________________________________________________________________________________________________________________________________________________________
120 ________________________________________________________________________________________________________________________________________________________________
121 ________________________________________________________________________________________________________________________________________________________________
122 ________________________________________________________________________________________________________________________________________________________________
123 _______________________________________________________________________________111111111111111111111111111______________________________________________________
124 ____________________________________________________________________________111__________________________1______________________________________________________
125 _________________________________________________________________________111_____________________________1______________________________________________________
126 _______________________________________________________________________11________________________________1______________________________________________________
127 ______________________________________________________________________1__________________________________1______________________________________________________
128 ______________________________________________________________________1__________________________________1______________________________________________________
129 _____________________________________________________________________1___________________________________1______________________________________________________
130 _____________________________________________________________________1___________________________________1______________________________________________________
131 ____________________________________________________________________1_________________________111111111111______________________________________________________
132 _____________________________________________________________________1_____________________111__________________________________________________________________
133 ______________________________________________________________________1_________________111_____________________________________________________________________
134 _______________________________________________________________________1_______111111111________________________________________________________________________
135 ________________________________________________________________________1111111_________________________________________________________________________________
136 ________________________________________________________________________________________________________________________________________________________________
137 ________________________________________________________________________________________________________________________________________________________________
138 ________________________________________________________________________________________________________________________________________________________________
139 ________________________________________________________________________________________________________________________________________________________________
140 ________________________________________________________________________________________________________________________________________________________________
141 ________________________________________________________________________________________________________________________________________________________________
142 ________________________________________________________________________________________________________________________________________________________________
143 ________________________________________________________________________________________________________________________________________________________________
144 _____________________________________________________________________________________________11111111111111111111111111111111111111111111111111111111111111_____
145 _____________________________________________________________________________________________1_____________________________________________1___1___1___1__1_____
146 ______________________________________________________________________________________________1____________________________________________1___1___1___1___1____
147 _______________________________________________________________________________________________1___________________________________________1___1___1___1___1____
148 ________________________________________________________________________________________________1__________________________________________1___1___1___1___1____
149 ________________________________________________________________________________________________111111__________11111111111________________1___1___1___1__11____
150 __________________________________________________________________________________________________11__11111___11___________11______________1___1___1___111______
151 ____________________________________________________________________________________________________11_____111_______________1111111_______1___1___1111_________
152 ______________________________________________________________________________________________________111111111111111111111111111111111111_1___1_11_____________
153 __________________________________________________________________________________________________________________________________________11___1__1_____________
154 __________________________________________________________________________________________________________________________________________11___1__1_____________
155 ___________________________________________________________________________________________________________________________________________1___1___1____________
156 ___________________________________________________________________________________________________________________________________________1___1___1____________
157 ____________________________________________________________________________________________________________________________________________1111____1___________
158 _______________________________________________________________________________________________________________________________________________11___1___________
159 ________________________________________________________________________________________________________________________________________________1___1___________
160 _________________________________________________________________________________________________________________________________________________1__1___________
161 _________________________________________________________________________________________________________________________________________________1__1___________
162 __________________________________________________________________________________________________________________________________________________1_1___________
163 __________________________________________________________________________________________________________________________________________________1_1___________
164 ___________________________________________________________________________________________________________________________________________________11___________
165 ___________________________________________________________________________________________________________________________________________________11___________
166 ________________________________________________________________________________________________________________________________________________________________
167 ________________________________________________________________________________________________________________________________________________________________
