    0         10        20        30        40        50        60        70        80        90        100       110       120       130       140       150       
    0123456789012345678901234567890123456789012345678901234567890123456789012345678901234567890123456789012345678901234567890123456789012345678901234567890123456789
0   ________________________________________________________________________________________________________________________________________________________________
1   ________________________________________________________________________________________________________________________________________________________________
2   ________________________________________________________________________________________________________________________________________________________________
3   ________________________________________________________________________________________________________________________________________________________________
4   ________________________________________________________________________________________________________________________________________________________________
5   ________________________________________________________________________________________________________________________________________________________________
6   ________________________________________________________________________________________________________________________________________________________________
7   ________________________________________________________________________________________________________________________________________________________________
8   ________________________________________________________________________________________________________________________________________________________________
9   ________________________________________________________________________________________________________________________________________________________________
10  ________________________________________________________________________________________________________________________________________________________________
11  ________________________________________________________________________________________________________________________________________________________________
12  ________________________________________________________________________________________________________________________________________________________________
13  ________________________________________________________________________________________________________________________________________________________________
14  ________________________________________________________________________________________________________________________________________________________________
15  ________________________________________________________________________________________________________________________________________________________________
16  ________________________________________________________________________________________________________________________________________________________________
17  ________________________________________________________________________________________________________________________________________________________________
18  ________________________________________________________________________________________________________________________________________________________________
19  ________________________________________________________________________________________________________________________________________________________________
20  ________________________________________________________________________________________________________________________________________________________________
21  ________________________________________________________________________________________________________________________________________________________________
22  ________________________________________________________________________________________________________________________________________________________________
23  ________________________________________________________________________________________________________________________________________________________________
24  ________________________________________________________________________________________________________________________________________________________________
25  ________________________________________________________________________________________________________________________________________________________________
26  ________________________________________________________________________________________________________________________________________________________________
27  ________________________________________________________________________________________________________________________________________________________________
28  ________________________________________________________________________________________________________________________________________________________________
29  ________________________________________________________________________________________________________________________________________________________________
30  ________________________________________________________________________________________________________________________________________________________________
31  ________________________________________________________________________________________________________________________________________________________________
32  ________________________________________________________________________________________________________________________________________________________________
33  ________________________________________________________________________________________________________________________________________________________________
34  ________________________________________________________________________________________________________________________________________________________________
35  ________________________________________________________________________________________________________________________________________________________________
36  ________________________________________________________________________________________________________________________________________________________________
37  ________________________________________________________________________________________________________________________________________________________________
38  ________________________________________________________________________________________________________________________________________________________________
39  ________________________________________________________________________________________________________________________________________________________________
40  ________________________________________________________________________________________________________________________________________________________________
41  ________________________________________________________________________________________________________________________________________________________________
42  ________________________________________________________________________________________________________________________________________________________________
43  ________________________________________________________________________________________________________________________________________________________________
44  ________________________________________________________________________________________________________________________________________________________________
45  ________________________________________________________________________________________________________________________________________________________________
46  ________________________________________________________________________________________________________________________________________________________________
47  ________________________________________________________________________________________________________________________________________________________________
48  ________________________________________________________________________________________________________________________________________________________________
49  ________________________________________________________________________________________________________________________________________________________________
50  ________________________________________________________________________________________________________________________________________________________________
51  ________________________________________________________________________________________________________________________________________________________________
52  ________________________________________________________________________________________________________________________________________________________________
53  ________________________________________________________________________________________________________________________________________________________________
54  ________________________________________________________________________________________________________________________________________________________________
55  ________________________________________________________________________________________________________________________________________________________________
56  ________________________________________________________________________________________________________________________________________________________________
57  ________________________________________________________________________________________________________________________________________________________________
58  ________________________________________________________________________________________________________________________________________________________________
59  ________________________________________________________________________________________________________________________________________________________________
60  ________________________________________________________________________________________________________________________________________________________________
61  ________________________________________________________________________________________________________________________________________________________________
62  ________________________________________________________________________________________________________________________________________________________________
63  ________________________________________________________________________________________________________________________________________________________________
64  ________________________________________________________________________________________________________________________________________________________________
65  ________________________________________________________________________________________________________________________________________________________________
66  ________________________________________________________________________________________________________________________________________________________________
67  ________________________________________________________________________________________________________________________________________________________________
68  ________________________________________________________________________________________________________________________________________________________________
69  ________________________________________________________________________________________________________________________________________________________________
70  ________________________________________________________________________________________________________________________________________________________________
71  ________________________________________________________________________________________________________________________________________________________________
72  ________________________________________________________________________________________________________________________________________________________________
73  ________________________________________________________________________________________________________________________________________________________________
74  ________________________________________________________________________________________________________________________________________________________________
75  ________________________________________________________________________________________________________________________________________________________________
76  ________________________________________________________________________________________________________________________________________________________________
77  ________________________________________________________________________________________________________________________________________________________________
78  ________________________________________________________________________________________________________________________________________________________________
79  ________________________________________________________________________________________________________________________________________________________________
80  ________________________________________________________________________________________________________________________________________________________________
81  ________________________________________________________________________________________________________________________________________________________________
82  ___________________________________________________________11111___11111________________________________________________________________________________________
83  ________________________________________________1__________1___1___1___1________________________________________________________________________________________
84  ________________________________________________1__11111___1___1___1___1___11111________________________________________________________________________________
85  ________________________________________________1__1___1___1___1___1___1___1___1________________________________________________________________________________
86  ________________________________________________1__1___1___1___1___1___1___1___1________________________________________________________________________________
87  ________________________________________________1__1___1___1___1___1___1___1___1________________________________________________________________________________
88  ________________________________________________1__1___1___1___1___1___1___1___1________________________________________________________________________________
89  ________________________________________________1__1___1___1___1___1___1___1___1________________________________________________________________________________
90  ___________________11111________________________1__1___1___1___1___1___1___1___1________________________________________________________________________________
91  ___________11111___1___1___________________1____1__1___1___1___1___1___1___1___1________________________________________________________________________________
92  ___________1___1___1___1___1_______________1____1__1___1___1___1___1___1___1___1________________________________________________________________________________
93  ___________1___1___1___1___1___11111_______1____1__1___1___1___1___1___1___1___1________________________________________________________________________________
94  ___________1___1___1___1___1___1___1___1___1____1__1___1___1___1___1___1___1___1________________________________________________________________________________
95  ___________1___1___1___1___1___1___1___1___1____1__1___1___1___1___1___1___1___1________________________________________________________________________________
96  ___________1___1___1___1___1___1___1___1___1___11__1___1___1___1___1___1___1___1________________________________________________________________________________
97  ___________1___1___1___1___1___1___1___1___1___1___1___1___1___1___1___1___1___1________________________________________________________________________________
98  ___________1___1___1___1___1___1___1___1___1___1___1___1___1___11__1___1___1___1___________111_________1111111__________________________________________________
99  ___________1___1___1___1___1___1___1___1___1___1___1___1___1_1111111___1___1___1__________1___11111111111111111_________________________________________________
100 ___________1___1___1___1___1___1___1___1___1___1___1___1___11______11__1___1___1__________1____________________11_______________________________________________
101 ___________1___1___1___1___1___1___1___1___1___1___1___1__1__________1111111___1_________1_______________________11111__________________________________________
102 ___________1___1___1___1___1___1___1___1___1___111111__111_____________111111111111111111____________________________1__________________________________________
103 ___________1___1___1___1___1___1___1___1_11111111111_111______________________________________________________________1_________________________________________
104 ___________1___1___1___1___1___1___111111____________1________________________________________________________________1_________________________________________
105 ___________1___1___1___1___1___1___11_______________1__________________________________________________________________1________________________________________
106 ___________1___1___1___1___1___1_11_1________11111111___________________________________________________________________11______________________________________
107 ___________1___1___1___1___1___11____111111111___111______________________________________________________________________1_____111111__________________________
108 ___________1___1___1___1___1_11______111_1___1111________________________________________________111111111111______________111111111111_________________________
109 ___________1___1___1___111111___________11111____________________________________________________1___________1_________________________1________________________
110 ___________1___1___1111111______________________________________________________________________1_____________1_________________________11______________________
111 ___________1___1_111____________________________________________________________________________1______________1__________________________1_____________________
112 ___________1___11_______________________________________________________________________________1_______________1__________________________1____________________
113 ___________1___11________________________________________________________________________________11____________1___________________________1____________________
114 ___________1___1___________________________________________________________________________________11________11____________________________1____________________
115 ___________1___1_____________________________________________________________________________________11___111_______________________________1___________________
116 ___________1__1________________________________________________________________________________________111__________________________________1___________________
117 ___________1__1_____________________________________________________________________________________________________________________________1___________________
118 ___________1__1_____________________________________________________________________________________________________________________________1___________________
119 ___________1__1______________________________________________________________________________________________________________________________1__________________
120 ___________1__1______________________________________________________________________________________________________________________________1__________________
121 ___________1__1______________________________________________________________________________________________________________________________111________________
122 ___________1__1_________________________________________________________________________________________________________________________________111111111111111_
123 ___________1__1_________________________________________________________________________________________________________________________________________________
124 ___________1__1_________________________________________________________________________________________________________________________________________________
125 ___________1111_________________________________________________________________________________________________________________________________________________
126 _111111_1111____________________________________________________________________________________________________________________________________________________
127 ________________________________________________________________________________________________________________________________________________________________
128 ________________________________________________________________________________________________________________________________________________________________
129 ________________________________________________________________________________________________________________________________________________________________
130 ________________________________________________________________________________________________________________________________________________________________
131 ________________________________________________________________________________________________________________________________________________________________
132 _____________________________________________________________________________________________________________________________________________111111111111111111_
133 _____________________________________________________________________________________________________________________________________________1__________________
134 _____________________________________________________________________________________________________________________________________________1__________________
135 _____________________________________________________________________________________________________________________________________________1__________________
136 _____________________________________________________________________________________________________________________________________________1__________________
137 _____________________________________________________________________________________________________________________________________________1__________________
138 ______________________________________________________________________________________________________________________________________________1_________________
139 ______________________________________________________________________________________________________________________________________________1_________________
140 _111111_1111__________________________________________________________________________________________________________________________________1_________________
141 ______1___1_1__________________________________________________________________________________________________________________________________1________________
142 ______1___1__1_________________________________________________________________________________________________________________________________1________________
143 ______1___1___1________________________________________________________________________________________________________________________________1________________
144 ______1___1___1________________________________________________________________________________________________________________________________1________________
145 ______1___1___11_______________________________________________________________________________________________________________________________1________________
146 ______1___1___1_1_____________________________________________________________________________________________________________________________1_________________
147 ______1___1___1__1____________________________________________________________________________________________________________________________1_________________
148 ______1___1___1___1___________________________________________________________________________________________________________________________1_________________
149 ______1___1___1____1__________________________________________________________________________________________________________________________1_________________
150 ______1___1___1____1_________________________________________________________________________________________________________________________1__________________
151 ______1___1___1_____1________________________________________________________________________________________________________________________1__________________
152 ______1___1___1______1_______________________________________________________________________________________________________________________1__________________
153 ______1___1___1______11______________________________________________________________________________________________________________________1__________________
154 ______1___1___1______1_11___________________________________________________________________________________________________________________1___________________
155 ______1___1___1______1___1__________________________________________________________________________________________________________________1___________________
156 ______1___1___1______1____1_________________________________________________________________________________________________________________1___________________
157 ______1___1___1______1_____1________________________________________________________________________________________________________________1___________________
158 ______1___1___1______1______1_______________________________________________________________________________________________________________1___________________
159 ______1___1___1______1______111_____________________________________________________________________________________________________________1___________________
160 ______1___1___1______1______1__1____________________________________________________________________________________________________________1___________________
161 ______1___1___1______1______1___1__________________________________________________________________________________________________________1____________________
162 ______1___1___1______1______1____1_________________________________________________________________________________________________________1____________________
163 ______1___1___1______1______1_____1_______________________________________________________________________________________________________1_____________________
164 ______1___1___1______1______1______11____________________________________________________________________________________________________1______________________
165 ______1___1___1______1______1________1___________________________________________________________________________________________________1______________________
166 _____________________1______1_________1_________________________________________________________________________________________________1_______________________
167 _____________________1______1_________1_________________________________________________________________________________________________________________________
