    0         10        20        30        40        50        60        70        80        90        100       110       120       130       140       150       
    0123456789012345678901234567890123456789012345678901234567890123456789012345678901234567890123456789012345678901234567890123456789012345678901234567890123456789
0   ________________________________________________________________________________________________________________________________________________________________
1   ________________________________________________________________________________________________________________________________________________________________
2   ________________________________________________________________________________________________________________________________________________________________
3   ________________________________________________________________________________________________________________________________________________________________
4   ________________________________________________________________________________________________________________________________________________________________
5   ________________________________________________________________________________________________________________________________________________________________
6   ________________________________________________________________________________________________________________________________________________________________
7   ________________________________________________________________________________________________________________________________________________________________
8   ________________________________________________________________________________________________________________________________________________________________
9   ________________________________________________________________________________________________________________________________________________________________
10  ________________________________________________________________________________________________________________________________________________________________
11  ________________________________________________________________________________________________________________________________________________________________
12  ________________________________________________________________________________________________________________________________________________________________
13  ________________________________________________________________________________________________________________________________________________________________
14  ________________________________________________________________________________________________________________________________________________________________
15  ________________________________________________________________________________________________________________________________________________________________
16  ________________________________________________________________________________________________________________________________________________________________
17  ________________________________________________________________________________________________________________________________________________________________
18  ________________________________________________________________________________________________________________________________________________________________
19  ________________________________________________________________________________________________________________________________________________________________
20  ________________________________________________________________________________________________________________________________________________________________
21  ________________________________________________________________________________________________________________________________________________________________
22  ________________________________________________________________________________________________________________________________________________________________
23  ________________________________________________________________________________________________________________________________________________________________
24  ________________________________________________________________________________________________________________________________________________________________
25  ________________________________________________________________________________________________________________________________________________________________
26  ________________________________________________________________________________________________________________________________________________________________
27  ________________________________________________________________________________________________________________________________________________________________
28  ________________________________________________________________________________________________________________________________________________________________
29  ________________________________________________________________________________________________________________________________________________________________
30  ________________________________________________________________________________________________________________________________________________________________
31  ________________________________________________________________________________________________________________________________________________________________
32  ________________________________________________________________________________________________________________________________________________________________
33  ________________________________________________________________________________________________________________________________________________________________
34  ________________________________________________________________________________________________________________________________________________________________
35  ________________________________________________________________________________________________________________________________________________________________
36  ________________________________________________________________________________________________________________________________________________________________
37  ________________________________________________________________________________________________________________________________________________________________
38  ________________________________________________________________________________________________________________________________________________________________
39  ________________________________________________________________________________________________________________________________________________________________
40  ________________________________________________________________________________________________________________________________________________________________
41  ________________________________________________________________________________________________________________________________________________________________
42  ________________________________________________________________________________________________________________________________________________________________
43  ________________________________________________________________________________________________________________________________________________________________
44  ________________________________________________________________________________________________________________________________________________________________
45  ______________________________________________________11111___11111___11111_____________________________________________________________________________________
46  ______________________________________11111___11111___1___1___1___1___1___1_____________________________________________________________________________________
47  ______________________________________1___1___1___1___1___1___1___1___1___1___________11111_____________________________________________________________________
48  ______________________________________1___1___1___1___1___1___1___1___1___1___________1___1_____________________________________________________________________
49  ______________________________________1___1___1___1___1___1___1___1___1___1___11111___1___1_____________________________________________________________________
50  ______________________________________1___1___1___1___1___1___1___1___1___1___1___1___1___1___11111_____________________________________________________________
51  ______________________________________1___1___1___1___1___1___1___1___1___1___1___1___1___1___1___1_____________________________________________________________
52  ______________________________________1___1___1___1___1___1___1___1___1___1___1___1___1___1___1___1_____________________________________________________________
53  ______________________________________1___1___1___1___1___1___1___1___1___1___1___1___1___1___1___1_____________________________________________________________
54  ______________________________________1___1___1___1___1___1___1___1___1___1___1___1___1___1___1___1_____________________________________________________________
55  ______________________________________1___1___1___1___1___1___1___1___1___1___1___1___1___1___1___1_____________________________________________________________
56  ______________________________________1___1___1___1___1___1___1___1___1___1___1___1___1___1___1___1_____________________________________________________________
57  ______________________________________1___1___1___1___1___1___1___1___1___1___1___1___1___1___1___1_____________________________________________________________
58  ______________________________________1___1___1___1___1___1___1___1___1___1___1___1___1___1___1___1_____________________________________________________________
59  ______________________________________1___1___1___11111111111111__1___1___1___1___1___1___1___1___1_____________________________________________________________
60  ______________________________________1___1___1____111__________1_1___1___1___1___1___1___1___1___1_____________________________________________________________
61  ______________________________________1___1___1___1______________11___1___1___1___1___1___1___1___1_____________________________________________________________
62  ______________________________________1___1___1_11________________11111__11111111111111___1___1___1_____________________________________________________________
63  ______________________________________1_11111111___________________111111__________11_1___1___1___1_____________________________________________________________
64  ____________________________________1111_____________________________________________11___1___1___1_____________________________________________________________
65  _________________________________111_________________________________________________11___1___1___1_____________________________________________________________
66  ______________________________111_____________________________________________________1___1___1___1_____________________________________________________________
67  ___________________________111________________________________________________________1___1___1___1_____________________________________________________________
68  _________________________11____________________________________________________________11111111___1_____________________________________________________________
69  ______________________111_________________________________________________________________11111111111111________________________________________________________
70  ____________________11__________________________________________________________________________________11111111________________________________________________
71  ________________1111____________________________________________________________________________________________1_______________________________________________
72  _______________11________________________________________________________________________________________________11_____________________________________________
73  ______________1_1__________________________________________________________________________________________________1____________________________________________
74  _____________1_1____________________________________________________________________________________________________1___________________________________________
75  _111111111111__1_____________________________________________________________________________________________________11_________________________________________
76  ______________1________________________________________________________________________________________________________1________________________________________
77  ______________1_________________________________________________________________________________________________________1_______________________________________
78  _____________1___________________________________________________________________________________________________________1______________________________________
79  _____________1___________________________________________________________________________________________________________1______________________________________
80  ____________1_____________________________________________________________________________________________________________1_____________________________________
81  ____________1_____________________________________________________________________________________________________________1_____________________________________
82  _1111111___1_______________________________________________________________________________________________________________1____________________________________
83  ________1__1________________________________________________________________________________________________________________1___________________________________
84  ________1_1__________________________________________________________________________________________________________________1__________________________________
85  _________11___________________________________________________________________________________________________________________1_________________________________
86  __________1____________________________________________________________________________________________________________________1________________________________
87  ___________1____________________________________________________________________________________________________________________1_______________________________
88  ____________1____________________________________________________________________________________________________________________1______________________________
89  _____________1____________________________________________________________________________________________________________________1_____________________________
90  ______________1____________________________________________________________________________________________________________________1____________________________
91  _______________1____________________________________________________________________________________________________________________1___________________________
92  ________________1____________________________________________________________________________________________________________________1__________________________
93  _________________1____________________________________________________________________________________________________________________1_________________________
94  __________________11___________________________________________________________________________________________________________________1________________________
95  ____________________1___________________________________________________________________________________________________________________1_______________________
96  _____________________1___________________________________________________________________________________________________________________1______________________
97  ______________________11__________________________________________________________________________________________________________________1_____________________
98  ________________________1_________________________________________________________________________1111111___1______________________________1____________________
99  _________________________1_______________________________________________________________________1_______1__1_______________________________1___________________
100 __________________________1______________________________________________________________________1________1_1________________________________1__________________
101 ___________________________11___________________________________________________________________1__________11_________________________________1_________________
102 _____________________________1_________________________________________________________________1____________11111______________________________1________________
103 ______________________________1________________________________________________________________1_____________1__1_______________________________1_______________
104 _______________________________1______________________________________________________________1_______________1_1________________________________1______________
105 ________________________________1_____________________________________________________________1________________11_________________________________1_____________
106 _________________________________11__________________________________________________________1__________________11111______________________________1____________
107 ___________________________________1________________________________________________________1____________________1__1_______________________________1___________
108 ____________________________________1_______________________________________________________1_____________________1_1________________________________1__________
109 _____________________________________111111111111_________________________________________11_______________________11_________________________________1_________
110 _________________________________________________111111111111111111111111______________111__________________________11111______________________________1________
111 _________________________________________________________________________11111111111111______________________________1__1_______________________________1_______
112 ______________________________________________________________________________________________________________________1_1________________________________1______
113 _______________________________________________________________________________________________________________________11_________________________________1_____
114 ________________________________________________________________________________________________________________________11111______________________________1____
115 _________________________________________________________________________________________________________________________1__1_______________________________1___
116 __________________________________________________________________________________________________________________________1_1________________________________1__
117 ___________________________________________________________________________________________________________________________11_________________________________1_
118 ____________________________________________________________________________________________________________________________11111_______________________________
119 _____________________________________________________________________________________________________________________________1__1_______________________________
120 ______________________________________________________________________________________________________________________________1_1_______________________________
121 _______________________________________________________________________________________________________________________________11_______________________________
122 ________________________________________________________________________________________________________________________________11111___________________________
123 _________________________________________________________________________________________________________________________________1__1___________________________
124 __________________________________________________________________________________________________________________________________1_1___________________________
125 ___________________________________________________________________________________________________________________________________11___________________________
126 ____________________________________________________________________________________________________________________________________11111_______________________
127 _____________________________________________________________________________________________________________________________________1__1_______________________
128 ______________________________________________________________________________________________________________________________________1_1_______________________
129 _______________________________________________________________________________________________________________________________________11_______________________
130 ________________________________________________________________________________________________________________________________________11111___________________
131 _________________________________________________________________________________________________________________________________________1__1___________________
132 __________________________________________________________________________________________________________________________________________1_1___________________
133 ___________________________________________________________________________________________________________________________________________11___________________
134 ____________________________________________________________________________________________________________________________________________11111_______________
135 _____________________________________________________________________________________________________________________________________________1__1_______________
136 ______________________________________________________________________________________________________________________________________________1_1_______________
137 _______________________________________________________________________________________________________________________________________________11_______________
138 ________________________________________________________________________________________________________________________________________________11111___________
139 _________________________________________________________________________________________________________________________________________________1__1___________
140 __________________________________________________________________________________________________________________________________________________1_1___________
141 ___________________________________________________________________________________________________________________________________________________11___________
142 ____________________________________________________________________________________________________________________________________________________11111_______
143 _____________________________________________________________________________________________________________________________________________________1__1_______
144 ______________________________________________________________________________________________________________________________________________________1_1_______
145 _______________________________________________________________________________________________________________________________________________________11_______
146 ________________________________________________________________________________________________________________________________________________________11111___
147 _________________________________________________________________________________________________________________________________________________________1__1___
148 __________________________________________________________________________________________________________________________________________________________1_1___
149 ___________________________________________________________________________________________________________________________________________________________11___
150 ____________________________________________________________________________________________________________________________________________________________111_
151 _____________________________________________________________________________________________________________________________________________________________1__
152 ______________________________________________________________________________________________________________________________________________________________1_
153 ________________________________________________________________________________________________________________________________________________________________
154 ________________________________________________________________________________________________________________________________________________________________
155 ________________________________________________________________________________________________________________________________________________________________
156 ________________________________________________________________________________________________________________________________________________________________
157 ________________________________________________________________________________________________________________________________________________________________
158 ________________________________________________________________________________________________________________________________________________________________
159 ________________________________________________________________________________________________________________________________________________________________
160 ________________________________________________________________________________________________________________________________________________________________
161 ________________________________________________________________________________________________________________________________________________________________
162 ________________________________________________________________________________________________________________________________________________________________
163 ________________________________________________________________________________________________________________________________________________________________
164 ________________________________________________________________________________________________________________________________________________________________
165 ________________________________________________________________________________________________________________________________________________________________
166 ________________________________________________________________________________________________________________________________________________________________
167 ________________________________________________________________________________________________________________________________________________________________
