    0         10        20        30        40        50        60        70        80        90        100       110       120       130       140       150       
    0123456789012345678901234567890123456789012345678901234567890123456789012345678901234567890123456789012345678901234567890123456789012345678901234567890123456789
0   ________________________________________________________________________________________________________________________________________________________________
1   ________________________________________________________________________________________________________________________________________________________________
2   ________________________________________________________________________________________________________________________________________________________________
3   ________________________________________________________________________________________________________________________________________________________________
4   ________________________________________________________________________________________________________________________________________________________________
5   ________________________________________________________________________________________________________________________________________________________________
6   ________________________________________________________________________________________________________________________________________________________________
7   ________________________________________________________________________________________________________________________________________________________________
8   ________________________________________________________________________________________________________________________________________________________________
9   ________________________________________________________________________________________________________________________________________________________________
10  ________________________________________________________________________________________________________________________________________________________________
11  ________________________________________________________________________________________________________________________________________________________________
12  ____________________________________________________________________________________________________________________________________1___________________________
13  __________________________________________________________________________11_______________________________________________________1_1________1_________________
14  _________________________________________________________________________1__11____________________________________________________1__1______11_1________________
15  _________________________________________________________________________1____11________________________11_______________________1____1____1____1_______________
16  ________________________________________________________________________1_______11_____________________1__111___________________1_____1____1_____1______________
17  _______________________________________________________________________11_________11__________________1______111_______________1_______11_1_______1_____________
18  ____________________________________11______________________________111_____________11________________1_________111___________1__________11________1____________
19  ___________________________________1__11___________________________1__________________1_________111__1_____________111_______1______________________1_________1_
20  ___________________________________1____111________________________1___________________11______1___11_________________1111111________________________1______11__
21  __________________________________1________111____________________1______________________11___1_______________________________________________________1____1____
22  __________________________________1___________11__________________1________________________11_1________________________________________________________1_11_____
23  ________________________________11______________111_____________11___________________________1__________________________________________________________1_______
24  _______________________________1___________________11__________1________________________________________________________________________________________________
25  _____________________________11______________________111_______1________________________________________________________________________________________________
26  ____________________________1___________________________111___1_________________________________________________________________________________________________
27  ___________________________1_______________________________11_1_________________________________________________________________________________________________
28  ___________________________1_________________________________11_________________________________________________________________________________________________
29  __________________________1_____________________________________________________________________________________________________________________________________
30  _________________________1______________________________________________________________________________________________________________________________________
31  _________________________1______________________________________________________________________________________________________________________________________
32  _______________________11_______________________________________________________________________________________________________________________________________
33  _______________________1________________________________________________________________________________________________________________________________________
34  _______________________1________________________________________________________________________________________________________________________________________
35  _______________________1________________________________________________________________________________________________________________________________________
36  _______________________1________________________________________________________________________________________________________________________________________
37  _______________________1________________________________________________________________________________________________________________________________________
38  ______________________1_________________________________________________________________________________________________________________________________________
39  ______________________1_________________________________________________________________________________________________________________________________________
40  ______________________1_________________________________________________________________________________________________________________________________________
41  ______________________1_________________________________________________________________________________________________________________________________________
42  ______________________1_________________________________________________________________________________________________________________________________________
43  ______________________1_________________________________________________________________________________________________________________________________________
44  ______________________1_________________________________________________________________________________________________________________________________________
45  _____________________1__________________________________________________________________________________________________________________________________________
46  _____________________1__________________________________________________________________________________________________________________________________________
47  ____________________1___________________________________________________________________________________________________________________________________________
48  ___________________1____________________________________________________________________________________________________________________________________________
49  __________________1_____________________________________________________________________________________________________________________________________________
50  __________________1_____________________________________________________________________________________________________________________________________________
51  _________________1______________________________________________________________________________________________________________________________________________
52  ________________1_______________________________________________________________________________________________________________________________________________
53  ________________1_______________________________________________________________________________________________________________________________________________
54  _______________1________________________________________________________________________________________________________________________________________________
55  _______________1________________________________________________________________________________________________________________________________________________
56  _______________1________________________________________________________________________________________________________________________________________________
57  ______________11________________________________________________________________________________________________________________________________________________
58  ____________11__________________________________________________________________________________________________________________________________________________
59  __________11____________________________________________________________________________________________________________________________________________________
60  __________1_____________________________________________________________________________________________________________________________________________________
61  _________1______________________________________________________________________________________________________________________________________________________
62  _________1______________________________________________________________________________________________________________________________________________________
63  _________1______________________________________________________________________________________________________________________________________________________
64  _________1______________________________________________________________________________________________________________________________________________________
65  ________1_______________________________________________________________________________________________________________________________________________________
66  ________1_______________________________________________________________________________________________________________________________________________________
67  ________1_______________________________________________________________________________________________________________________________________________________
68  ________1_______________________________________________________________________________________________________________________________________________________
69  _______1________________________________________________________________________________________________________________________________________________________
70  _______1________________________________________________________________________________________________________________________________________________________
71  _______1________________________________________________________________________________________________________________________________________________________
72  ______1_________________________________________________________________________________________________________________________________________________________
73  ______1_________________________________________________________________________________________________________________________________________________________
74  ______1_________________________________________________________________________________________________________________________________________________________
75  ______1_________________________________________________________________________________________11111___________________________________________________________
76  _____1__________________________________________________________________________________________1___1___11111___________________________________________________
77  _____1__________________________________________________________________________________11111___1___1___1___1___________________________________________________
78  _____1__________________________________________________________________________11111___1___1___1___1___1___1___________________________________________________
79  _____1__________________________________________________11111___11111___11111___1___1___1___1___1___1___1___1___________________________________________________
80  ____1___________________________________________________1___1___1___1___1___1___1___1___1___1___1___1___1___1___11111___11111___11111___________________________
81  ____1___________________________________________11111___1___1___1___1___1___1___1___1___1___1___1___1___1___1___1___1___1___1___1___1___________________________
82  ____1___________________________________________1___1___1___1___1___1___1___1___1___1___1___1___1___1___1___1___1___1___1___1___1___1___11111___11111___________
83  ____1___________________________________________1___1___1___1___1___1___1___1___1___1___1___1___1___1___1___1___1___1___1___1___1___1___1___1___1___1___11111___
84  ___1____________________________________11111___1___1___1___1___1___1___1___1___1___1___1___1___1___1___1___1___1___1___1___1___1___1___1___1___1___1___1___1___
85  ___1____________________________________1___1___1___1___1___1___1___1___1___1___1___1___1___1___1___1___1___1___1___1___1___1___1___1___1___1___1___1___1___1___
86  ___1____________________________________1___1___1___1___1___1___1___1___1___1___1___1___1___1___1___1___1___1___1___1___1___1___1___1___1___1___1___1___1___1___
87  ___1____________________________________1___1___1___1___1___1___1___1___1___1___1___1___1___1___1___1___1___1___1___1___1___1___1___1___1___1___1___1___1___1___
88  ___1____________________________________1___1___1___1___1___1___1___1___1___1___1___1___1___1___1___1___1___1___1___1___1___1___1___1___1___1___1___1___1___1___
89  ___1____________________________________1___1___1___1___1___1___1___1___1___1___1___1___1___1___1___1___1___1___1___1___1___1___1___1___1___1___1___1___1___1___
90  ___1____________________________________1___1___1___1___1___1___1___1___1___1___1___1___1___1___1___1___1___1___1___1___1___1___1___1___1___1___1___1___1___1___
91  ___1____________________________________1___1___1___1___1___1___1___1___1___1___1___1___1___1___1___1___1___1___1___1___1___1___1___1___1___1___1___1___1___1___
92  ___1____________________________________1___1___1___1___1___1___1___1___1___1___1___1___1___1___1___1___1___1___1___1___1___1___1___1___1___1___1___1___1___1___
93  ___1____________________________________1___1___1___1___1___1___1___1___1___1___1___1___1___11111___1___1___1___1___1___1___1___1___1___1___1___1___1___1___1___
94  ___1____________________________________1___1___1___1___1___1___1___1___1___1___1___1___1__11___111_1___1___1___1___1___1___1___1___1___1___1___1___1___1___1___
95  ___1____________________________________1___1___1___1___1___1___1111111111__1___1___1___1_1________11___1___1___1___1___1___1___1___1___1___1___1___1___1___1___
96  ___1____________________________________1___1__1111111111___1__11_________1111111___1___11__________1___1___1___1___1___1___1___1___1___1___1___1___1___1___1___
97  ___1____________________________________1___1_1________1111_1_1______________11_____11111__________11___1___1___1___1___1___1___1___1___1___1___1___1___1___1___
98  __1_____________________________________1___1_1____________111_________________11____11____________11___1___1___1___1___1___1___1___1___1___1___1___1___1___1___
99  __1_____________________________________1____1____________________________________111______________11___1___1___1___1___1___1___1___1___1___1___1___1___1___1___
100 __1_____________________________________1__11______________________________________________________11___1___1___1___1___1___1___1___1___1___1___1___1___1___1___
101 __1_____________________________________111_______________________________________________________1_1___1___1___1___1___1___1___1___1___1___1___1___1___1___1___
102 __1____________________________________11_________________________________________________________1_1___1___1___1___1___1___1___1___1___1___1___1___1___1___1___
103 _11111111111111111111111111111111111111___________________________________________________________1_1___1___1___1___1___1___1___1___1___1___1___1___1___1___1___
104 __1________________________________________________________________________________________________11___1___1___1___1___1___11111___1___1___1___1___1___1___1___
105 __1_________________________________________________________________________________________________1___1___1___1___1___1__11___11__1___1___1___1___11111___1___
106 __1__________________________________________________________________________________________________1__1___1___1___1111111_______1111111___11111111111111__1___
107 __1__________________________________________________________________________________________________1__1___1___1____1_______________111111111____________11111_
108 ___1__________________________________________________________________________________________________1_1___1111111111__________________________________________
109 ___1__________________________________________________________________________________________________1_1111____________________________________________________
110 ___1___________________________________________________________________________________________________11_______________________________________________________
111 ___1____________________________________________________________________________________________________________________________________________________________
112 ___1____________________________________________________________________________________________________________________________________________________________
113 ___1____________________________________________________________________________________________________________________________________________________________
114 ___1____________________________________________________________________________________________________________________________________________________________
115 ___1____________________________________________________________________________________________________________________________________________________________
116 ___1____________________________________________________________________________________________________________________________________________________________
117 ___1____________________________________________________________________________________________________________________________________________________________
118 ___1____________________________________________________________________________________________________________________________________________________________
119 ____1___________________________________________________________________________________________________________________________________________________________
120 ____1___________________________________________________________________________________________________________________________________________________________
121 ____1___________________________________________________________________________________________________________________________________________________________
122 ____1___________________________________________________________________________________________________________________________________________________________
123 ____1___________________________________________________________________________________________________________________________________________________________
124 _111111111111111111111_11_______________________________________________________________________________________________________________________________________
125 ____1___________________1_______________________________________________________________________________________________________________________________________
126 ____1___________________1_______________________________________________________________________________________________________________________________________
127 _____1__________________1_______________________________________________________________________________________________________________________________________
128 _____1__________________1_______________________________________________________________________________________________________________________________________
129 _____1__________________1_______________________________________________________________________________________________________________________________________
130 ______1_________________1_______________________________________________________________________________________________________________________________________
131 ______1_________________1_______________________________________________________________________________________________________________________________________
132 ______1_________________1_______________________________________________________________________________________________________________________________________
133 ______1_________________1_______________________________________________________________________________________________________________________________________
134 _______1________________1_______________________________________________________________________________________________________________________________________
135 _______1________________1_______________________________________________________________________________________________________________________________________
136 _______1_________________1______________________________________________________________________________________________________________________________________
137 ________1________________1______________________________________________________________________________________________________________________________________
138 ________1________________1______________________________________________________________________________________________________________________________________
139 ________1________________1______________________________________________________________________________________________________________________________________
140 _________1_______________1______________________________________________________________________________________________________________________________________
141 _________1________________1_____________________________________________________________________________________________________________________________________
142 _________1________________1_____________________________________________________________________________________________________________________________________
143 __________1_______________1_____________________________________________________________________________________________________________________________________
144 __________1_______________1_____________________________________________________________________________________________________________________________________
145 ___________11______________1____________________________________________________________________________________________________________________________________
146 _____________11____________1______________________________________________________________________________________________111___________________________________
147 _______________11__________1__________________________________________________________________________________________1111___11_________________________________
148 _________________1_________1______________________________________________________________________________________1111_________11_______________________________
149 _________________1_________1__________________________________________________________________________________1111_______________11_____________________________
150 __________________1________1_______11______________________________________________________1111111________1111_____________________11___________________________
151 __________________1________1_____11__11____________________111________________________11111_______11111111___________________________11_________________________
152 ___________________11______1___11______11_______________111___1111__________________11_________________________________________________1________________________
153 _____________________11____1__1__________111________1111__________1111_____11111________________________________________________________11______________________
154 _______________________1_1__11______________11___111__________________11111_______________________________________________________________1_____________________
155 __________________________11__111_____________111__________________________________________________________________________________________1____________________
156 _________________________________1_1________________________________________________________________________________________________________11__________________
157 ____________________________________111_______________________________________________________________________________________________________1_________________
158 _______________________________________11______________________________________________________________________________________________________1________________
159 _________________________________________111__________________________________________________________11111111111111____________________________11______________
160 ____________________________________________11_____________________________________1111_11111111111111______________1111111111____________________11____________
161 _______________________________________________111____________11111111111_1111111_____________________________________________111111111_____________1111________
162 __________________________________________________1111111111_1___________________________________________________________________1____1111111111________1111____
163 _________________________________________________________________________________________________________________________________1____1____1____1111111111__111_
164 _________________________________________________________________________________________________________________________________1____1____1____1____1____11111_
165 _________________________________________________________________________________________________________________________________1____1____1____1____1____1_____
166 _________________________________________________________________________________________________________________________________1____1____1____1____1____1_____
167 _________________________________________________________________________________________________________________________________1____1____1____1____1____1_____
