    0         10        20        30        40        50        60        70        80        90        100       110       120       130       140       150       
    0123456789012345678901234567890123456789012345678901234567890123456789012345678901234567890123456789012345678901234567890123456789012345678901234567890123456789
0   ________________________________________________________________________________________________________________________________________________________________
1   ________________________________________111111111111111111111111111_____________11111111111111111111____________________________________________________________
2   ________________________________________111111111111111111111111111_____________11111111111111111111____________________________________________________________
3   ________________________________________111111111111111111111111111_____________11111111111111111111____________________________________________________________
4   ________________________________________111111111111111111111111111_____________11111111111111111111____________________________________________________________
5   ________________________________________111111111111111111111111111_____________11111111111111111111____________________________________________________________
6   ________________________________________111111111111111111111111111_____________11111111111111111111____________________________________________________________
7   ________________________________________111111111111111111111111111_____________11111111111111111111____________________________________________________________
8   ________________________________________111111111111111111111111111_____________11111111111111111111____________________________________________________________
9   ________________________________________111111111111111111111111111_____________11111111111111111111____________________________________________________________
10  ________________________________________111111111111111111111111111_____________11111111111111111111____________________________________________________________
11  ________________________________________111111111111111111111111111_____________11111111111111111111____________________________________________________________
12  ________________________________________111111111111111111111111111_____________11111111111111111111____________________________________________________________
13  ________________________________________111111111111111111111111111_____________11111111111111111111____________________________________________________________
14  ________________________________________111111111111111111111111111_____________11111111111111111111____________________________________________________________
15  ________________________________________111111111111111111111111111_____________11111111111111111111____________________________________________________________
16  ________________________________________111111111111111111111111111_____________11111111111111111111____________________________________________________________
17  ________________________________________111111111111111111111111111_____________11111111111111111111____________________________________________________________
18  ________________________________________111111111111111111111111111_____________11111111111111111111____________________________________________________________
19  ________________________________________111111111111111111111111111_____________11111111111111111111____________________________________________________________
20  ________________________________________111111111111111111111111111_____________11111111111111111111____________________________________________________________
21  ________________________________________111111111111111111111111111____________111111111111111111111____________________________________________________________
22  ________________________________________111111111111111111111111111____________111111111111111111111____________________________________________________________
23  ________________________________________111111111111111111111111111____________111111111111111111111____________________________________________________________
24  ________________________________________111111111111111111111111111____________111111111111111111111____________________________________________________________
25  ________________________________________111111111111111111111111111____________111111111111111111111____________________________________________________________
26  ________________________________________111111111111111111111111111____________111111111111111111111____________________________________________________________
27  ________________________________________111111111111111111111111111____________111111111111111111111____________________________________________________________
28  ________________________________________111111111111111111111111111____________111111111111111111111____________________________________________________________
29  ________________________________________111111111111111111111111111____________111111111111111111111____________________________________________________________
30  ________________________________________111111111111111111111111111____________111111111111111111111____________________________________________________________
31  ________________________________________111111111111111111111111111____________111111111111111111111____________________________________________________________
32  ________________________________________111111111111111111111111111____________111111111111111111111____________________________________________________________
33  ________________________________________111111111111111111111111111____________111111111111111111111____________________________________________________________
34  ________________________________________111111111111111111111111111____________111111111111111111111____________________________________________________________
35  ________________________________________111111111111111111111111111____________111111111111111111111____________________________________________________________
36  ________________________________________111111111111111111111111111____________111111111111111111111____________________________________________________________
37  ________________________________________111111111111111111111111111____________111111111111111111111____________________________________________________________
38  ________________________________________111111111111111111111111111____________111111111111111111111____________________________________________________________
39  ________________________________________111111111111111111111111_______________111111111111111111111____________________________________________________________
40  ___________________________________________111111111111111_____________________111111111111111111111____________________________________________________________
41  ________________________________________________11111__________________________11111111111111111________________________________________________________________
42  ___________________________________________________________________________________1111111______________________________________________________________________
43  ________________________________________________________________________________________________________________________________________________________________
44  ________________________________________________________________________________________________________________________________________________________________
45  ________________________________________________________________________________________________________________________________________________________________
46  ________________________________________________________________________________________________________________________________________________________________
47  ________________________________________________________________________________________________________________________________________________________________
48  ________________________________________________________________________________________________________________________________________________________________
49  ________________________________________________________________________________________________________________________________________________________________
50  ________________________________________________________________________________________________________________________________________________________________
51  ________________________________________________________________________________________________________________________________________________________________
52  ________________________________________________________________________________________________________________________________________________________________
53  ________________________________________________________________________________________________________________________________________________________________
54  ________________________________________________________________________________________________________________________________________________________________
55  ________________________________________________________________________________________________________________________________________________________________
56  ________________________________________________________________________________________________________________________________________________________________
57  ___________________1111111111111111_____________________________________________________________________________________________________________________________
58  __________________1__1___1____1_1__111__________________________________________________________________________________________________________________________
59  _________________1___1___1____1_1___1_11________________________________________________________________________________________________________________________
60  ________________1____1___1____1_1___1___111111111111111111111111111111__________________________________________________________________________________________
61  ________________11___1___1____1_1___1_____1111___1___1___1___1_______1__________________________________________________________________________________________
62  ________________111111___111111_1111111111____1111___1___1___1___11111__________________________________________________________________________________________
63  __________________11_1111111111111111___111111111111_1___11111111_______________________________________________________________________________________________
64  ____________________11111111111111111111____________111111______________________________________________________________________________________________________
65  ________________________________________________________________________________________________________________________________________________________________
66  ________________________________________________________________________________________________________________________________________________________________
67  ________________________________________________________________________________________________________________________________________________________________
68  ________________________________________________________________________________________________________________________________________________________________
69  ________________________________________________________________________________________________________________________________________________________________
70  ________________________________________________________________________________________________________________________________________________________________
71  ________________________________________________________________________________________________________________________________________________________________
72  ________________________________________________________________________________________________________________________________________________________________
73  ________________________________________________________________________________________________________________________________________________________________
74  ________________________________________________________________________________________________________________________________________________________________
75  ________________________________________________________________________________________________________________________________________________________________
76  ________________________________________________________________________________________________________________________________________________________________
77  ________________________________________________________________________________________________________________________________________________________________
78  ________________________________________________________________________________________________________________________________________________________________
79  ________________________________________________________________________________________________________________________________________________________________
80  _______________________________________________________________________1111111111_______________________________________________________________________________
81  ___________________________________________________________________1111111___111111_________________1111111111111111111111______________________________________
82  ________________________________________________________________111__1___1___1___1_11__________1111111111___11111_____1___1111__________________________________
83  ______________________________________________________________11_____1___1___1___1___1________11____1___1___1___1_____1______11111______________________________
84  _______________________________________________________________1111111___1___1___1__11__________11111___1___1___1_____1______1____11____________________________
85  _____________________________________________________________________111_11111___111________________111_1___1___1_____1______1____1_____________________________
86  ________________________________________________________________________111111111______________________11___1___1_____1______1____1_____________________________
87  _________________________________________________________________________________________________________11_1___1_____1______1___1______________________________
88  ___________________________________________________________________________________________________________11___1_____1_____11111_______________________________
89  _____________________________________________________________________________________________________________111111111111111____________________________________
90  ________________________________________________________________________________________________________________________________________________________________
91  ________________________________________________________________________________________________________________________________________________________________
92  _11111111111111_________________________________________________________________________________________________________________________________________________
93  ___1___1___111111_______________________________________________________________________________________________________________________________________________
94  ___1___1___1___1_11_____________________________________________________________________________________________________________________________________________
95  ___1___1___1___1___1____________________________________________________________________________________________________________________________________________
96  _111___11111_111111____________________11111111111111111111111111111111111______________________________________________________________________________________
97  ____111111111__________________________1______1______1______1______1_____1______________________________________________________________________________________
98  _______________________________________1______1______1______1______1_____1______________________________________________________________________________________
99  _______________________________________1______1______1______1______1______1_____________________________________________________________________________________
100 _______________________________________1______1______1______1______1______1_____________________________________________________________________________________
101 _______________________________________1111111111____1______1______1_____11_____________________________________________________________________________________
102 _________________________________________________11__1______1______1___11_______________________________________________________________________________________
103 ___________________________________________________11111111111111111111_________________________________________________________________________________________
104 ________________________________________________________________________________________________________________________________________________________________
105 ________________________________________________________________________________________________________________________________________________________________
106 ________________________________________________________________________________________________________________________________________________________________
107 ________________________________________________________________________________________________________________________________________________________________
108 ________________________________________________________________________________________________________________________________________________________________
109 ________________________________________________________________________________________________________________________________________________________________
110 ________________________________________________________________________________________________________________________________________________________________
111 ________________________________________________________________________________________________________________________________________________________________
112 ________________________________________________________________________________________________________________________________________________________________
113 ________________________________________________________________________________________________________________________________________________________________
114 ________________________________________________________________________________________________________________________________________________________________
115 ________________________________________________________________________________________________________________________________________________________________
116 ________________________________________________________________________________________________________________________________________________________________
117 ________________________________________________________________________________________________________________________________________________________________
118 ________________________________________________________________________________________________________________________________________________________________
119 ________________________________________________________________________________________________________________________________________________________________
120 ________________________________________________________________________________________________________________________________________________________________
121 ________________________________________________________________________________________________________________________________________________________________
122 ________________________________________________________________________________________________________________________________________________________________
123 ________________________________________________________________________________________________________________________________________________________________
124 ________________________________________________________________________________________________________________________________________________________________
125 ________________________________________________________________________________________________________________________________________________________________
126 ________________________________________________________________________________________________________________________________________________________________
127 ________________________________________________________________________________________________________________________________________________________________
128 ________________________________________________________________________________________________________________________________________________________________
129 ________________________________________________________________________________________________________________________________________________________________
130 ________________________________________________________________________________________________________________________________________________________________
131 ________________________________________________________________________________________________________________________________________________________________
132 ________________________________________________________________________________________________________________________________________________________________
133 ________________________________________________________________________________________________________________________________________________________________
134 ________________________________________________________________________________________________________________________________________________________________
135 ________________________________________________________________________________________________________________________________________________________________
136 ________________________________________________________________________________________________________________________________________________________________
137 _____________11111111111111111111111111111111111111_____________________________________________________________________________________________________________
138 ____________11___1___11111___1___1____1_______1____111__________________________________________________________________________________________________________
139 __________11_1___1___1___1___1___1____1_______1_____1_11________________________________________________________________________________________________________
140 __________1__1___1___1___1___1___1____1_______1_____1___111_____________________________________________________________________________________________________
141 _________1___1___1___1___1___1___1____1_______1_____1______11___________________________________________________________________________________________________
142 _________1___1___1___1___1___1___1____1_______1_____1_______1___________________________________________________________________________________________________
143 _________1___1___1___1___1___1___1____1_______1___11111111111___________________________________________________________________________________________________
144 _________111_1___1___1___1___1___1____1_______1_11______________________________________________________________________________________________________________
145 ____________1111111111___1___1___1____1111111111________________________________________________________________________________________________________________
146 __________________111111_11111_11111111_________________________________________________________________________________________________________________________
147 ________________________1111111_________________________________________________________________________________________________________________________________
148 ________________________________________________________________________________________________________________________________________________________________
149 ________________________________________________________________________________________________________________________________________________________________
150 ________________________________________________________________________________________________________________________________________________________________
151 ________________________________________________________________________________________________________________________________________________________________
152 ________________________________________________________________________________________________________________________________________________________________
153 ________________________________________________________________________________________________________________________________________________________________
154 ________________________________________________________________________________________________________________________________________________________________
155 ________________________________________________________________________________________________________________________________________________________________
156 ________________________________________________________________________________________________________________________________________________________________
157 ________________________________________________________________________________________________________________________________________________________________
158 ________________________________________________________________________________________________________________________________________________________________
159 ________________________________________________________________________________________________________________________________________________________________
160 ________________________________________________________________________________________________________________________________________________________________
161 ________________________________________________________________________________________________________________________________________________________________
162 ________________________________________________________________________________________________________________________________________________________________
163 ________________________________________________________________________________________________________________________________________________________________
164 ________________________________________________________________________________________________________________________________________________________________
165 ________________________________________________________________________________________________________________________________________________________________
166 ________________________________________________________________________________________________________________________________________________________________
167 ________________________________________________________________________________________________________________________________________________________________
