    0         10        20        30        40        50        60        70        80        90        100       110       120       130       140       150       
    0123456789012345678901234567890123456789012345678901234567890123456789012345678901234567890123456789012345678901234567890123456789012345678901234567890123456789
0   ________________________________________________________________________________________________________________________________________________________________
1   ________________________________111111111111111111____________________________________________________________1111111111111111111111111111111111111111111111111_
2   ________________________________111111111111111111____________________________________________________________1111111111111111111111111111111111111111111111111_
3   ________________________________111111111111111111____________________________________________________________1111111111111111111111111111111111111111111111111_
4   ________________________________111111111111111111____________________________________________________________1111111111111111111111111111111111111111111111111_
5   ________________________________111111111111111111____________________________________________________________1111111111111111111111111111111111111111111111111_
6   ________________________________111111111111111111____________________________________________________________1111111111111111111111111111111111111111111111111_
7   ________________________________111111111111111111____________________________________________________________1111111111111111111111111111111111111111111111111_
8   ________________________________111111111111111111____________________________________________________________1111111111111111111111111111111111111111111111111_
9   ________________________________111111111111111111____________________________________________________________1111111111111111111111111111111111111111111111111_
10  ________________________________111111111111111111____________________________________________________________1111111111111111111111111111111111111111111111111_
11  ________________________________111111111111111111____________________________________________________________1111111111111111111111111111111111111111111111111_
12  ________________________________111111111111111111____________________________________________________________1111111111111111111111111111111111111111111111111_
13  ________________________________111111111111111111____________________________________________________________1111111111111111111111111111111111111111111111111_
14  ________________________________111111111111111111____________________________________________________________1111111111111111111111111111111111111111111111111_
15  ________________________________111111111111111111____________________________________________________________1111111111111111111111111111111111111111111111111_
16  ________________________________111111111111111111____________________________________________________________1111111111111111111111111111111111111111111111111_
17  ________________________________111111111111111111____________________________________________________________1111111111111111111111111111111111111111111111111_
18  ________________________________111111111111111111____________________________________________________________1111111111111111111111111111111111111111111111111_
19  ________________________________111111111111111111____________________________________________________________1111111111111111111111111111111111111111111111111_
20  ________________________________111111111111111111____________________________________________________________1111111111111111111111111111111111111111111111111_
21  _______________________________1111111111111111111____________________________________________________________1111111111111111111111111111111111111111111111111_
22  _______________________________1111111111111111111____________________________________________________________1111111111111111111111111111111111111111111111111_
23  _______________________________1111111111111111111____________________________________________________________1111111111111111111111111111111111111111111111111_
24  _______________________________1111111111111111111____________________________________________________________1111111111111111111111111111111111111111111111111_
25  _______________________________1111111111111111111____________________________________________________________1111111111111111111111111111111111111111111111111_
26  _______________________________1111111111111111111____________________________________________________________1111111111111111111111111111111111111111111111111_
27  _______________________________1111111111111111111____________________________________________________________1111111111111111111111111111111111111111111111111_
28  _______________________________1111111111111111111____________________________________________________________1111111111111111111111111111111111111111111111111_
29  _______________________________1111111111111111111____________________________________________________________1111111111111111111111111111111111111111111111111_
30  _______________________________1111111111111111111____________________________________________________________1111111111111111111111111111111111111111111111111_
31  _______________________________1111111111111111111____________________________________________________________1111111111111111111111111111111111111111111111111_
32  _______________________________1111111111111111111____________________________________________________________1111111111111111111111111111111111111111111111111_
33  _______________________________1111111111111111111____________________________________________________________1111111111111111111111111111111111111111111111111_
34  _______________________________1111111111111111111____________________________________________________________1111111111111111111111111111111111111111111111111_
35  _______________________________1111111111111111111____________________________________________________________1111111111111111111111111111111111111111111111111_
36  _______________________________1111111111111111111____________________________________________________________1111111111111111111111111111111111111111111111111_
37  _______________________________1111111111111111111____________________________________________________________1111111111111111111111111111111111111111111111111_
38  _______________________________1111111111111111111____________________________________________________________1111111111111111111111111111111111111111111111111_
39  _______________________________1111111111111111111____________________________________________________________1111111111111111111111111111111111111111111111111_
40  _______________________________1111111111111111111____________________________________________________________1111111111111111111111111111111111111111111111111_
41  _________________________________11111111111111111______________________________________________________33333333________________________________________________
42  ___________________________________111111111111111_____________________________________________________3333333333_______________________________________________
43  _____________________________________________________________________________________________________3333333333333______________________________________________
44  _________________________________________________________________________________________________333333333333333333_____________________________________________
45  ________________________________________________________________________________________________3333333333333333333_____________________________________________
46  _______________________________________________________________________________________________333333333333333333333____________________________________________
47  ______________________________________________________________________________________________33333333333333333333333___________________________________________
48  ______________________________________________________________________________________________33333333333333333333333___________________________________________
49  _____________________________________________________________________________________________3333333333333333333333333__________________________________________
50  _____________________________________________________________________________________________3333333333333333333333333__________________________________________
51  ____________________________________________________________________________________________333333333333333333333333333_________________________________________
52  ____________________________________________________________________________________________333333333333333333333333333_________________________________________
53  ___________________________________________________________________________________________33333333333333333333333333333________________________________________
54  ___________________________________________________________________________________________33333333333333333333333333333________________________________________
55  __________________________________________________________________________________________3333333333333333333333333333333_______________________________________
56  __________________________________________________________________________________________33333333333333333333333333333333_________111111111111111111111________
57  _________________________________________________________________________________________3333333333333333333333333333333333_______1____1___1___1___1___1________
58  _________________________________________________________________________________________33333333333333333333333333333333333______1____1___1___1___1___1________
59  ________________________________________________________________________________________333333333333333333333333333333333333_____11____1___1__1111111111________
60  ________________________________________________________________________________________3333333333333333333333333333333333333______1111111111111________________
61  _______________________________________________________________________________________3333333333333333333333333_3333333333333__________________________________
62  _______________________________________________________________________________________3333333333333333333333333__33333333333333________________________________
63  ______________________________________________________________________________________3333333333333333333333333____333_3333333333_______________________________
64  ______________________________________________________________________________________3333333333333333333333333________333333333333____________________33333333_
65  ______________________________________________________________________________________3333333333333333333333333________333333333333333____3_______3333333333333_
66  _____________________________________________________________________________________3333333333333333333333333_________3333333333333333333333333333333333333333_
67  _____________________________________________________________________________________33333333333333333333333331111111113333333333333333333333333333333333333333_
68  _____________________________________________________________________________________33333333333333333333333331_______13333333333333333333333333333333333333333_
69  ____________________________________________________________________________________333333333333333333333333331_______13333333333333333333333333333333333333333_
70  ____________________________________________________________________________________333333333333333333333333331111111113333333333333333333333333333333333333333_
71  ____________________________________________________________________________________333333333333333333333333333333333333333333333333333333333333333333333333333_
72  __________________________________1111111111111111111111111111111111111_____________333333333333333333333333333333333333333333333333333333333333333333333333333_
73  __________________________________1___________________________________1_____________333333333333333333333333333333333333333333333333333333333333333333333333333_
74  __________________________________1___________________________________1_____________333333333333333333333333333333333333333333333333333333333333333333333333333_
75  __________________________________1_________________________________11______________3333333333333333333___33333333333333333333333333333333333333333333333333333_
76  __________________________________111111___________________________1________________333333333333333333_____3333333333333333333333333333333333333333333333333333_
77  ________________________________________11_______________________11_________________3333333333333333_______3333333333333333333333333333333333333333333333333333_
78  __________________________________________1____________________11____________________33333333333333________3333333333333333333333333333333333333333333333333333_
79  ___________________________________________11111111111111111111______________________33333333333333_______33333333333333333333333333333333333333333333333333333_
80  _____________________________________________________________________________________33333333333333_______33333333333333333333333333333333333333333333333333333_
81  ______________________________________________________________________________________333333333333___________33333333333333333333333333333333333333333333333333_
82  ______________________________________________________________________________________333333333333____________3333333333333333333333333333333333333333333333333_
83  ______________________________________________________________________________________3333333333331111111111113333333333333333333333333333333333333333333333333_
84  ______________________________________________________________________________________33333333333331_________13333333333333333333333333333333333333333333333333_
85  _______________________________________________________________________________________333333333333_1_______133333333333333333333333333333333333333333333333333_
86  _______________________________________________________________________________________3333333333333_1111111133333333333333333333333333333333333333333333333333_
87  _______________________________________________________________________________________333333333333333333333333333333333333333333333333333333333333333333333333_
88  _______________________________________________________________________________________333333333333333333333333333333333333333333333333333333333333333333333333_
89  ________________________________________________________________________________________33333333333333333333333333333333333333333333333333333333333333333333333_
90  ________________________________________________________________________________________33333333333333333333333333333333333333333333333333333333333333333333333_
91  _________________________________________________________________________________________3333333333333333333333333333333333333333333333333333333333333333333333_
92  _________________________________________________________________________________________3333333333333333333333333333333333333333333333333333333333333333333333_
93  _________________________________________________________________________________________3333333333333333333333333333333333333333333333333333333333333333333333_
94  __________________________________________________________________________________________333333333333333333333333333333333333333333333333333333333333333333333_
95  __________________________________________________________________________________________333333333333333333333333333333333333333333333333333333333333333333333_
96  __________________________________________________________________________________________333333333333333333333333333333333333333333333333333333333333333333333_
97  __________________________________________________________________________________________333333333333333333333333333333333333333333333333333333333333333333333_
98  ___________________________________________________________________________________________33333333333333333333333333333333333333333333333333333333333333333333_
99  ___________________________________________________________________________________________33333333333333333333333333333333333333333333333333333333333333333333_
100 _____________________________________________________________________________________________333333333333333333333333333333333333333333333333333333333333333333_
101 _______________________________________________________________________________________________3333333333333333333333333333333333333333333333333333333333333333_
102 ________________________________________________________________________________________________33333333333333333333333333333333333333333333333333333333333333__
103 __________________________________________________________________________________________________3333333333333333333333333333333333333333333333333333333333____
104 ____________________________________________________________________________________________________33333333333333333333333333333333333333333333333333333_______
105 _______________________________________________________________________________________________________3333333333333_____333333____3333333333333333333__________
106 __________________________________________________________________________________________________________3333_______________________33333333333333_____________
107 _______________________________________________________________________________________________________________________________________33333333_________________
108 ________________________________________________________________________________________________________________________________________________________________
109 ________________________________________________________________________________________________________________________________________________________________
110 ________________________________________________________________________________________________________________________________________________________________
111 ________________________________________________________________________________________________________________________________________________________________
112 ________________________________________________________________________________________________________________________________________________________________
113 ________________________________________________________________________________________________________________________________________________________________
114 ________________________________________________________________________________________________________________________________________________________________
115 ________________________________________________________________________________________________________________________________________________________________
116 ________________________________________________________________________________________________________________________________________________________________
117 ________________________________________________________________________________________________________________________________________________________________
118 ________________________________________________________________________________________________________________________________________________________________
119 ________________________________________________________________________________________________________________________________________________________________
120 ________________________________________________________________________________________________________________________________________________________________
121 ________________________________________________________________________________________________________________________________________________________________
122 ________________________________________________________________________________________________________________________________________________________________
123 ________________________________________________________________________________________________________________________________________________________________
124 ________________________________________________________________________________________________________________________________________________________________
125 ________________________________________________________________________________________________________________________________________________________________
126 ________________________________________________________________________________________________________________________________________________________________
127 ________________________________________________________________________________________________________________________________________________________________
128 ________________________________________________________________________________________________________________________________________________________________
129 ________________________________________________________________________________________________________________________________________________________________
130 ________________________________________________________________________________________________________________________________________________________________
131 ________________________________________________________________________________________________________________________________________________________________
132 ________________________________________________________________________________________________________________________________________________________________
133 ________________________________________________________________________________________________________________________________________________________________
134 ________________________________________________________________________________________________________________________________________________________________
135 ________________________________________________________________________________________________________________________________________________________________
136 ________________________________________________________________________________________________________________________________________________________________
137 ________________________________________________________________________________________________________________________________________________________________
138 ________________________________________________________________________________________________________________________________________________________________
139 ________________________________________________________________________________________________________________________________________________________________
140 ________________________________________________________________________________________________________________________________________________________________
141 ________________________________________________________________________________________________________________________________________________________________
142 ________________________________________________________________________________________________________________________________________________________________
143 ________________________________________________________________________________________________________________________________________________________________
144 ________________________________________________________________________________________________________________________________________________________________
145 ________________________________________________________________________________________________________________________________________________________________
146 ________________________________________________________________________________________________________________________________________________________________
147 ________________________________________________________________________________________________________________________________________________________________
148 ________________________________________________________________________________________________________________________________________________________________
149 ________________________________________________________________________________________________________________________________________________________________
150 ________________________________________________________________________________________________________________________________________________________________
151 ________________________________________________________________________________________________________________________________________________________________
152 ________________________________________________________________________________________________________________________________________________________________
153 ________________________________________________________________________________________________________________________________________________________________
154 ________________________________________________________________________________________________________________________________________________________________
155 ________________________________________________________________________________________________________________________________________________________________
156 ________________________________________________________________________________________________________________________________________________________________
157 ________________________________________________________________________________________________________________________________________________________________
158 ________________________________________________________________________________________________________________________________________________________________
159 ________________________________________________________________________________________________________________________________________________________________
160 ________________________________________________________________________________________________________________________________________________________________
161 ________________________________________________________________________________________________________________________________________________________________
162 ________________________________________________________________________________________________________________________________________________________________
163 ________________________________________________________________________________________________________________________________________________________________
164 ________________________________________________________________________________________________________________________________________________________________
165 ________________________________________________________________________________________________________________________________________________________________
166 ________________________________________________________________________________________________________________________________________________________________
167 ________________________________________________________________________________________________________________________________________________________________
