    0         10        20        30        40        50        60        70        80        90        100       110       120       130       140       150       
    0123456789012345678901234567890123456789012345678901234567890123456789012345678901234567890123456789012345678901234567890123456789012345678901234567890123456789
0   ________________________________________________________________________________________________________________________________________________________________
1   ________________________________________________________________________________________________________________________________________________________________
2   ________________________________________________________________________________________________________________________________________________________________
3   ________________________________________________________________________________________________________________________________________________________________
4   ________________________________________________________________________________________________________________________________________________________________
5   ________________________________________________________________________________________________________________________________________________________________
6   ________________________________________________________________________________________________________________________________________________________________
7   ________________________________________________________________________________________________________________________________________________________________
8   ________________________________________________________________________________________________________________________________________________________________
9   ________________________________________________________________________________________________________________________________________________________________
10  ________________________________________________________________________________________________________________________________________________________________
11  ________________________________________________________________________________________________________________________________________________________________
12  ________________________________________________________________________________________________________________________________________________________________
13  ________________________________________________________________________________________________________________________________________________________________
14  ________________________________________________________________________________________________________________________________________________________________
15  ________________________________________________________________________________________________________________________________________________________________
16  ________________________________________________________________________________________________________________________________________________________________
17  ________________________________________________________________________________________________________________________________________________________________
18  ________________________________________________________________________________________________________________________________________________________________
19  ________________________________________________________________________________________________________________________________________________________________
20  ________________________________________________________________________________________________________________________________________________________________
21  ________________________________________________________________________________________________________________________________________________________________
22  ________________________________________________________________________________________________________________________________________________________________
23  ________________________________________________________________________________________________________________________________________________________________
24  ________________________________________________________________________________________________________________________________________________________________
25  ________________________________________________________________________________________________________________________________________________________________
26  ________________________________________________________________________________________________________________________________________________________________
27  ________________________________________________________________________________________________________________________________________________________________
28  ________________________________________________________________________________________________________________________________________________________________
29  ________________________________________________________________________________________________________________________________________________________________
30  ________________________________________________________________________________________________________________________________________________________________
31  ________________________________________________________________________________________________________________________________________________________________
32  ________________________________________________________________________________________________________________________________________________________________
33  ________________________________________________________________________________________________________________________________________________________________
34  ________________________________________________________________________________________________________________________________________________________________
35  ________________________________________________________________________________________________________________________________________________________________
36  ________________________________________________________________________________________________________________________________________________________________
37  ________________________________________________________________________________________________________________________________________________________________
38  ________________________________________________________________________________________________________________________________________________________________
39  ________________________________________________________________________________________________________________________________________________________________
40  ________________________________________________________________________________________________________________________________________________________________
41  ________________________________________________________________________________________________________________________________________________________________
42  ________________________________________________________________________________________________________________________________________________________________
43  ________________________________________________________________________________________________________________________________________________________________
44  ________________________________________________________________________________________________________________________________________________________________
45  ________________________________________________________________________________________________________________________________________________________________
46  ________________________________________________________________________________________________________________________________________________________________
47  ________________________________________________________________________________________________________________________________________________________________
48  ________________________________________________________________________________________________________________________________________________________________
49  ________________________________________________________________________________________________________________________________________________________________
50  ________________________________________________________________________________________________________________________________________________________________
51  ________________________________________________________________________________________________________________________________________________________________
52  ________________________________________________________________________________________________________________________________________________________________
53  ________________________________________________________________________________________________________________________________________________________________
54  ________________________________________________________________________________________________________________________________________________________________
55  ________________________________________________________________________________________________________________________________________________________________
56  ________________________________________________________________________________________________________________________________________________________________
57  ________________________________________________________________________________________________________________________________________________________________
58  ________________________________________________________________________________________________________________________________________________________________
59  ________________________________________________________________________________________________________________________________________________________________
60  ________________________________________________________________________________________________________________________________________________________________
61  ________________________________________________________________________________________________________________________________________________________________
62  ________________________________________________________________________________________________________________________________________________________________
63  ________________________________________________________________________________________________________________________________________________________________
64  ________________________________________________________________________________________________________________________________________________________________
65  ________________________________________________________________________________________________________________________________________________________________
66  ________________________________________________________________________________________________________________________________________________________________
67  _________________________________1111111111111111111111111111___________________________________________________________________________________________________
68  ________________________________1______1_______1_______1_____1111_______________________________________________________________________________________________
69  ________________________________1______1_______1_______1_________11_____________________________________________________________________________________________
70  _______________________________1_______1_______1_______1__________1_____________________________________________________________________________________________
71  _______________________________111111111111111111111111111111111111_______________________________________________________________111111111111111111111111______
72  _________________________________________________________________________________________________________________________________1_______11111__1___1___1_11____
73  _________________________________________________________________________________________________________________________________1_______1___1__1___1___1___1___
74  11111___________________________________________________________________________________________________________________________1________1___1__1___1___1____11_
75  _____1111111111_________________________________________________________________________________________________________________1________1___1__1___1___1______1
76  ____11111___111111111111_______________________________________________________________________________________________________1_________1___1__1___1___1_____1_
77  ____1___1___1___1___11111111111111______________________________________________________________________________________________11_______1___1__1___1___1___11__
78  ____1___1___1___1___1___1_______1_1111111111______________________________________________________________________________________11_____1___1111___11111__1____
79  ____1___1___1___1___1___1_______1______1____11111______________________________111111111111111______________________________________11111111111111111111111_____
80  ____1___1___1___1___1___1_______1______1_____1___1____________________________11___1___11111__111_______________________________________________________________
81  ____1___1___1___1___1___1_______1______1_____1____1________________________111_1___1___1___1__1__11_____________________________________________________________
82  ____1___1___1___1___1___1_______1______1_____1____1______________________111___1___1___1___1__1___1_____________________________________________________________
83  ____1___1___1___1___1___1_______1______1_____1_____1____________________1__1___1___1___1___1__1___1_____________________________________________________________
84  ____1___1___1___1___1___1_______1______1_____1_____1___________________1___1___1___1___1___1__1___1_____________________________________________________________
85  ____1___1___1___1___1___1_______1______1_____1_____1__________________1____1___1__111__1___1__1__11_____________________________________________________________
86  ____1___1___1___1___1___1_______1______1_____1_____1__________________1____1111111_11111___1__111_______________________________________________________________
87  ____1___1___1___1___1___1_______1______1_____1_____1__________________111111111________111_1111_________________________________________________________________
88  ____1___1___1___1___1___1_______1______1_____1_____1______________________________________111___________________________________________________________________
89  ____1___1___1___1___1___1_______1______1_____1___111____________________________________________________________________________________________________________
90  ____1___1___1___1___1___1_______1______1_____1111_______________________________________________________________________________________________________________
91  ____1___1___1___1___1___1_______1______111111___________________________________________________________________________________________________________________
92  ____1___1___1___1___1___1_______1___1111________________________________________________________________________________________________________________________
93  11__1___1___1___1___1___1______11111____________________________________________________________________________________________________________________________
94  __1111__1111____11111___1__1111_________________________________________________________________________________________________________________________________
95  ______111111111111111111111_____________________________________________________________________________________________________________________________________
96  ________________________________________________________________________________________________________________________________________________________________
97  ________________________________________________________________________________________________________________________________________________________________
98  ________________________________________________________________________________________________________________________________________________________________
99  ________________________________________________________________________________________________________________________________________________________________
100 ________________________________________________________________________________________________________________________________________________________________
101 ________________________________________________________________________________________________________________________________________________________________
102 ________________________________________________________________________________________________________________________________________________________________
103 ________________________________________________________________________________________________________________________________________________________________
104 ________________________________________________________________________________________________________________________________________________________________
105 ________________________________________________________________________________________________________________________________________________________________
106 ________________________________________________________________________________________________________________________________________________________________
107 ________________________________________________________________________________________________________________________________________________________________
108 ________________________________________________________________________________________________________________________________________________________________
109 ________________________________________________________________________________________________________________________________________________________________
110 ________________________________________________________________________________________________________________________________________________________________
111 ________________________________________________________________________________________________________________________________________________________________
112 ________________________________________________________________________________________________________________________________________________________________
113 ________________________________________________________________________________________________________________________________________________________________
114 ________________________________________________________________________________________________________________________________________________________________
115 ________________________________________________________________________________________________________________________________________________________________
116 ________________________________________________________________________________________________________________________________________________________________
117 ________________________________________________________________________________________________________________________________________________________________
118 _____________________________________________________________________________________________1______1111111111__________________________________________________
119 _____________________________________________________________________________________________1111111__1_______111_______________________________________________
120 ____________________________________________________________________________________________1_________1_________1_______________________________________________
121 ____________________________________________________________________________________________1_________1_________1_______________________________________________
122 _____________________________________________________________________________________________11_______1_________1_______________________________________________
123 _______________________________________________________________________________________________1______1_______11________________________________________________
124 ________________________________________________________________________________________________1_____1_____11__________________________________________________
125 _________________________________________________________________________________________________11___1____1____________________________________________________
126 ___________________________________1111111_________________________________________________________1__1__11_____________________________________________________
127 ________________________11111111111_____1_111_______________________________________________________11111_______________________________________________________
128 __________________111111__1______1______1____111______________________________________________________1_________________________________________________________
129 _________________111111___1______1______1_______111_____________________________________________________________________________________________________________
130 ________________1_1___1___1______1______1_______1__111__________________________________________________________________________________________________________
131 _______________1__1___1___1______1______1_______1_____111_______________________________________________________________________________________________________
132 ______________1___1___1___1______1______1_______1_______1111____________________________________________________________________________________________________
133 _____________11___1___1___1______1______1_______1_______1___11__________________________________________________________________________________________________
134 ____________1_1___1___1___1______1______1_______1_______1____1__________________________________________________________________________________________________
135 ___________1__1___1___1___1______1______1_______1_______1_____1_________________________________________________________________________________________________
136 __________1___1___1___1___1______1______1_______1_______1_____1_________________________________________________________________________________________________
137 ___________1__1___1___1___1______1______1_______1_______1_____1_________________________________________________________________________________________________
138 ___________1__1___1___1___1______1______1_______1_______1____1__________________________________________________________________________________________________
139 ____________1_1___1___1___1______1______1_______1_______1___1___________________________________________________________________________________________________
140 ____________1_1___1___1___1______1______1_______1_______1__1____________________________________________________________________________________________________
141 _____________11___1___1___1______1______1_______1_______111_____________________________________________________________________________________________________
142 _____________11___1___1___1______1______1_______1_______1_______________________________________________________________________________________________________
143 ______________11111___11111______1______1_______1______1________________________________________________________________________________________________________
144 ______________11111111111________1______1_______1___111_________________________________________________________________________________________________________
145 _________________________111111__1______1_______1111____________________________________________________________________________________________________________
146 _______________________________1111111__1__11111________________________________________________________________________________________________________________
147 ______________________________________11111_____________________________________________________________________________________________________________________
148 ________________________________________________________________________________________________________________________________________________________________
149 ________________________________________________________________________________________________________________________________________________________________
150 ________________________________________________________________________________________________________________________________________________________________
151 ________________________________________________________________________________________________________________________________________________________________
152 ________________________________________________________________________________________________________________________________________________________________
153 ________________________________________________________________________________________________________________________________________________________________
154 ________________________________________________________________________________________________________________________________________________________________
155 ________________________________________________________________________________________________________________________________________________________________
156 ________________________________________________________________________________________________________________________________________________________________
157 ________________________________________________________________________________________________________________________________________________________________
158 ________________________________________________________________________________________________________________________________________________________________
159 ________________________________________________________________________________________________________________________________________________________________
160 ________________________________________________________________________________________________________________________________________________________________
161 ________________________________________________________________________________________________________________________________________________________________
162 ________________________________________________________________________________________________________________________________________________________________
163 ________________________________________________________________________________________________________________________________________________________________
164 ________________________________________________________________________________________________________________________________________________________________
165 ________________________________________________________________________________________________________________________________________________________________
166 ________________________________________________________________________________________________________________________________________________________________
167 ________________________________________________________________________________________________________________________________________________________________
