    0         10        20        30        40        50        60        70        80        90        100       110       120       130       140       150       
    0123456789012345678901234567890123456789012345678901234567890123456789012345678901234567890123456789012345678901234567890123456789012345678901234567890123456789
0   ________________________________________________________________________________________________________________________________________________________________
1   ________________________________________________________________________________________________________________________________________________________________
2   ________________________________________________________________________________________________________________________________________________________________
3   ________________________________________________________________________________________________________________________________________________________________
4   ________________________________________________________________________________________________________________________________________________________________
5   ________________________________________________________________________________________________________________________________________________________________
6   ________________________________________________________________________________________________________________________________________________________________
7   ________________________________________________________________________________________________________________________________________________________________
8   ________________________________________________________________________________________________________________________________________________________________
9   ________________________________________________________________________________________________________________________________________________________________
10  ________________________________________________________________________________________________________________________________________________________________
11  ________________________________________________________________________________________________________________________________________________________________
12  ________________________________________________________________________________________________________________________________________________________________
13  ________________________________________________________________________________________________________________________________________________________________
14  ________________________________________________________________________________________________________________________________________________________________
15  ________________________________________________________________________________________________________________________________________________________________
16  ________________________________________________________________________________________________________________________________________________________________
17  ________________________________________________________________________________________________________________________________________________________________
18  ________________________________________________________________________________________________________________________________________________________________
19  ________________________________________________________________________________________________________________________________________________________________
20  ________________________________________________________________________________________________________________________________________________________________
21  ________________________________________________________________________________________________________________________________________________________________
22  ________________________________________________________________________________________________________________________________________________________________
23  ________________________________________________________________________________________________________________________________________________________________
24  ________________________________________________________________________________________________________________________________________________________________
25  ________________________________________________________________________________________________________________________________________________________________
26  ________________________________________________________________________________________________________________________________________________________________
27  ________________________________________________________________________________________________________________________________________________________________
28  ________________________________________________________________________________________________________________________________________________________________
29  ________________________________________________________________________________________________________________________________________________________________
30  ________________________________________________________________________________________________________________________________________________________________
31  ________________________________________________________________________________________________________________________________________________________________
32  ________________________________________________________________________________________________________________________________________________________________
33  ________________________________________________________________________________________________________________________________________________________________
34  ________________________________________________________________________________________________________________________________________________________________
35  ________________________________________________________________________________________________________________________________________________________________
36  ________________________________________________________________________________________________________________________________________________________________
37  ________________________________________________________________________________________________________________________________________________________________
38  ________________________________________________________________________________________________________________________________________________________________
39  ________________________________________________________________________________________________________________________________________________________________
40  ________________________________________________________________________________________________________________________________________________________________
41  ________________________________________________________________________________________________________________________________________________________________
42  ________________________________________________________________________________________________________________________________________________________________
43  ________________________________________________________________________________________________________________________________________________________________
44  ______________________________________________________________________11111___11111_____________________________________________________________________________
45  ______________________________________________________________________1___1___1___1_____________________________________________________________________________
46  ______________________________________________________________________1___1___1___1_____________________________________________________________________________
47  ______________________________________________________________________1___1___1___1_____________________________________________________________________________
48  ______________________________________________________________________1___1___1___1_____________________________________________________________________________
49  ______________________________________________________________________1___1___1___1_____________________________________________________________________________
50  ______________________________________________________________11111___1___1___1___1_____________________________________________________________________________
51  ______________________________________________________________1___1___1___1___1___1_____________________________________________________________________________
52  ______________________________________________________________1___1___1___1___1___1___11111_____________________________________________________________________
53  ______________________________________________________________1___1___1___1___1___1___1___1_____________________________________________________________________
54  ______________________________________________________________1___1___1___1___1___1___1___1___1_________________________________________________________________
55  ______________________________________________________________1___1___1___1___1___1___1___1___1_________________________________________________________________
56  ______________________________________________________________1___1___1___1___1___1___1___1___1_________________________________________________________________
57  ______________________________________________________________1___1___1___1___1___1___1___1___1_________________________________________________________________
58  ______________________________________________________________1___1___1___1___1___1___1___1___1_________________________________________________________________
59  ______________________________________________________________1___1___1___1___1___1___1___1___1_________________________________________________________________
60  ______________________________________________________________1___1___1___1___1___1___1___1___1_________________________________________________________________
61  ______________________________________________________________1___1___1___1___1___1___1___1___1_________________________________________________________________
62  ______________________________________________________________1___1___1___1___1___1___1___1___1_________________________________________________________________
63  ______________________________________________________________1___1___1___1___1___1___1___1___1_________________________________________________________________
64  ______________________________________________________________1___1___1___1___1___1___1___1___1_________________________________________________________________
65  ______________________________________________________________1___1___1___1___1___1___1___1___1_________________________________________________________________
66  ______________________________________________________________1___1___1___1___1___1___1___1___1_________________________________________________________________
67  ______________________________________________________________1___1___1___1___1___1___1___1___1_________________________________________________________________
68  ______________________________________________________________1___1___1___1___1___1___1___1___1_________________________________________________________________
69  ______________________________________________________________1___1___1___1___1___1___1___1___1_________________________________________________________________
70  ______________________________________________________________1___1___1___1___1___1___1___1___1_________________________________________________________________
71  ______________________________________________________________1___1___1___1111111_1___1___1___1_________________________________________________________________
72  ______________________________________________________________1___1___1___1_____1_1___1___1___1_________________________________________________________________
73  ______________________________________________________________1___1___1___1______11___1___1___1_________________________________________________________________
74  ______________________________________________________________1___1___1___1______11___1___1___1_________________________________________________________________
75  ______________________________________________________________1___1___1___1_______1___1___1___1_________________________________________________________________
76  ______________________________________________________________1___1___1___1_______11111___1___1_________________________________________________________________
77  ______________________________________________________________1___1___1___1_______1_111111111111111111111111111111111111________________________________________
78  ______________________________________________________________1___1___1___1________11__________________________________1________________________________________
79  ______________________________________________________________1___1___1___1________11___________________________________1_______________________________________
80  _____________________________________11111111111111111111111111111111111111_____________________________________________1_______________________________________
81  _____________________________________1___________________________________________________________________________________1______________________________________
82  _____________________________________1___________________________________________________________________________________1______________________________________
83  _____________________________________1___________________________________________________________________________________1______________________________________
84  ____________________________________1_____________________________________________________________________________________1_____________________________________
85  ____________________________________1_____________________________________________________________________________________1_____________________________________
86  ____________________________________1______________________________________________________________________________________1____________________________________
87  ____________________________________1______________________________________________________________________________________1____________________________________
88  ___________________________________1_______________________________________________________________________________________1____________________________________
89  ___________________________________1________________________________________________________________________________________1___________________________________
90  ___________________________________1________________________________________________________________________________________1___________________________________
91  ___________________________________1_________________________________________________________________________________________1__________________________________
92  __________________________________1__________________________________________________________________________________________1__________________________________
93  __________________________________1__________________________________________________________________________________________1__________________________________
94  __________________________________1___________________________________________________________________________________________1_________________________________
95  _________________________________1____________________________________________________________________________________________1_________________________________
96  _________________________________1____________________________________________________________________________111111111111111111________________________________
97  _________________________________1____________________________________________________________________________111111111111111111________________________________
98  _________________________________1____________________________________________________________________________1_________________________________________________
99  ________________________________1______________________________________________________________________________1________________________________________________
100 ________________________________1______________________________________________________________________________1________________________________________________
101 ________________________________1______________________________________________________________________________1________________________________________________
102 ________________________________1____________________________1111111111111111111111111_________________________1________________________________________________
103 _______________________________1_____________________________1_______________________1__________________________1_______________________________________________
104 _1111111111111111161111111111111_____________________________1_______________________1__________________________1_______________________________________________
105 __________________6_________________________________________1_________________________1_________________________1_______________________________________________
106 __________________6_________________________________________1_________________________1__________________________1______________________________________________
107 __________________6_________________________________________1_________________________1__________________________1______________________________________________
108 __________________6_________________________________________1_________________________1__________________________1______________________________________________
109 __________________6________________________________________1___________________________1_________________________1______________________________________________
110 __________________6________________________________________1___________________________1__________________________1_____________________________________________
111 __________________6________________________________________1___________________________1__________________________11111111111111111_____________________________
112 __________________6__________________________1111111111____1___________________________1____111111111_____________________________1_____________________________
113 __________________6__________________________1________1____1___________________________1____1_______1______________________________1____________________________
114 __________________6__________________________1________1___1_____________________________1___1_______1______________________________1____________________________
115 __________________6_______________________________________1_____________________________1__________________________________________1____________________________
116 __________________6_______________________________________1_____________________________1__________________________________________1____________________________
117 __________________6_______________________________________1_____________________________1___________________________________________1___________________________
118 __________________6_______________________________________1______________________________1__________________________________________1___________________________
119 __________________6______________________________________1_______________________________1__________________________________________1___________________________
120 __________________6______________________________________1_______________________________1___________________________________________1__________________________
121 __________________6______________________________________1_______________________________1___________________________________________1__________________________
122 __________________6______________________________________1_______________________________1___________________________________________1__________________________
123 __________________6_____________________________________1_________________________________1__________________________________________1__________________________
124 __________________6_____________________________________1_________________________________1___________________________________________1_________________________
125 111111111111111111611111111_____________________________1_________________________________1___________________________________________1_________________________
126 __________________________1_____________________________1_________________________________1___________________________________________1_________________________
127 __________________________1_____________________________1_________________________________1____________________________________________1________________________
128 __________________________1____________________________1___________________________________1___________________________________________1________________________
129 __________________________1____________________________1___________________________________1________________________3__________________1________________________
130 __________________________1____________________________1___________________________________1_______________________33__________________1________________________
131 _________________________11____________________________1___________________________________1_____________________33333__________________1_______________________
132 _________________________1____________________________1_____________________________________1__________________3333333______1111111111111_______________________
133 _________________________1____________________________1_____________________________________1________________3333333333_____1___________________________________
134 ________________________1_____________________________111111111111111111111111111111111111111_________________33333333333____1__________________________________
135 ________________________1_____________________________________________________________________________________3333333333333__1__________________________________
136 ________________________1______________________________________________________________________________________333333333333331__________________________________
137 ________________________1___333333______________________________________________________________________________33333333333331__________________________________
138 _______________________1___33333333____33_________________________________________________________________________3333333333331_________________________________
139 _______________________1___33333333___3333333____________________________________________________________________33333333333331_________________________________
140 _______________________1____33333333__333333333__________________________________________________________________33333333333331_________________________________
141 _______________________1____33333333_3333333333________________________________________________________________3333333333333331_________________________________
142 ______________________1______3333333333333333333_______________________________________________________________33333333333333__1________________________________
143 ______________________1______3333333333333333333_______________________________________________________________3333333333333___1________________________________
144 ______________________1_____3333333333333333333________________________________________________________________33333333333333__1________________________________
145 ______________________1_____3333333333333333333_________________________________________________________________3333333333333___1_______________________________
146 _____________________1_____3333333333333333333_______________________________________________________________________33333333___1_______________________________
147 _____________________1____33333333333333333333_________________________________________________________________________333333___1_______________________________
148 _____________________1____3333333333333333333____________________________________________________________________________33_____1_______________________________
149 _____________________1____333333333333333333_____________________________________________________________________________________1______________________________
150 ____________________1________333333333___________________________________________________________________________________________1______________________________
151 ____________________1___________33333____________________________________________________________________________________________1______________________________
152 ____________________1____________333_____________________________________________________________________________________________1______________________________
153 ____________________1_____________3_______________________________________________________________________________________________1_____________________________
154 ___________________1______________________________________________________________________________________________________________11111111111111________________
155 ___________________1___________________________________________________________________________________________________________444444444444____1________________
156 ___________________1___________________________________________________________________________________________________________________________1________________
157 ___________________1____________________________________________________________________________________________________________________________1_______________
158 __________________1_____________________________________________________________________________________________________________________________1_______________
159 _________________11111111111111111111111111111111111111111111111111111111111111111111111111111111111111111111111111111111111111111111111111111111_______________
160 ________________________________________________________________________________________________________________________________________________________________
161 ________________________________________________________________________________________________________________________________________________________________
162 ________________________________________________________________________________________________________________________________________________________________
163 ________________________________________________________________________________________________________________________________________________________________
164 ________________________________________________________________________________________________________________________________________________________________
165 ________________________________________________________________________________________________________________________________________________________________
166 ________________________________________________________________________________________________________________________________________________________________
167 ________________________________________________________________________________________________________________________________________________________________
