    0         10        20        30        40        50        60        70        80        90        100       110       120       130       140       150       
    0123456789012345678901234567890123456789012345678901234567890123456789012345678901234567890123456789012345678901234567890123456789012345678901234567890123456789
0   ________________________________________________________________________________________________________________________________________________________________
1   ________________________________________________________________________________________________________________________________________________________________
2   ________________________________________________________________________________________________________________________________________________________________
3   ________________________________________________________________________________________________________________________________________________________________
4   ________________________________________________________________________________________________________________________________________________________________
5   ________________________________________________________________________________________________________________________________________________________________
6   ________________________________________________________________________________________________________________________________________________________________
7   ________________________________________________________________________________________________________________________________________________________________
8   ________________________________________________________________________________________________________________________________________________________________
9   ________________________________________________________________________________________________________________________________________________________________
10  ________________________________________________________________________________________________________________________________________________________________
11  ________________________________________________________________________________________________________________________________________________________________
12  ________________________________________________________________________________________________________________________________________________________________
13  ________________________________________________________________________________________________________________________________________________________________
14  ________________________________________________________________________________________________________________________________________________________________
15  ________________________________________________________________________________________________________________________________________________________________
16  ________________________________________________________________________________________________________________________________________________________________
17  ________________________________________________________________________________________________________________________________________________________________
18  ________________________________________________________________________________________________________________________________________________________________
19  ________________________________________________________________________________________________________________________________________________________________
20  ________________________________________________________________________________________________________________________________________________________________
21  ________________________________________________________________________________________________________________________________________________________________
22  ________________________________________________________________________________________________________________________________________________________________
23  ________________________________________________________________________________________________________________________________________________________________
24  ________________________________________________________________________________________________________________________________________________________________
25  ________________________________________________________________________________________________________________________________________________________________
26  ________________________________________________________________________________________________________________________________________________________________
27  ________________________________________________________________________________________________________________________________________________________________
28  ________________________________________________________________________________________________________________________________________________________________
29  ________________________________________________________________________________________________________________________________________________________________
30  ________________________________________________________________________________________________________________________________________________________________
31  ________________________________________________________________________________________________________________________________________________________________
32  ________________________________________________________________________________________________________________________________________________________________
33  ________________________________________________________________________________________________________________________________________________________________
34  ________________________________________________________________________________________________________________________________________________________________
35  ________________________________________________________________________________________________________________________________________________________________
36  ________________________________________________________________________________________________________________________________________________________________
37  ________________________________________________________________________________________________________________________________________________________________
38  ________________________________________________________________________________________________________________________________________________________________
39  ________________________________________________________________________________________________________________________________________________________________
40  ________________________________________________________________________________________________________________________________________________________________
41  ________________________________________________________________________________________________________________________________________________________________
42  ________________________________________________________________________________________________________________________________________________________________
43  ________________________________________________________________________________________________________________________________________________________________
44  ________________________________________________________________________________________________________________________________________________________________
45  ________________________________________________________________________________________________________________________________________________________________
46  ________________________________________________________________________________________________________________________________________________________________
47  ________________________________________________________________________________________________________________________________________________________________
48  ________________________________________________________________________________________________________________________________________________________________
49  ________________________________________________________________________________________________________________________________________________________________
50  ________________________________________________________________________________________________________________________________________________________________
51  ________________________________________________________________________________________________________________________________________________________________
52  ________________________________________________________________________________________________________________________________________________________________
53  ________________________________________________________________________________________________________________________________________________________________
54  ________________________________________________________________________________________________________________________________________________________________
55  ________________________________________________________________________________________________________________________________________________________________
56  ________________________________________________________________________________________________________________________________________________________________
57  ________________________________________________________________________________________________________________________________________________________________
58  ________________________________________________________________________________________________________________________________________________________________
59  ________________________________________________________________________________________________________________________________________________________________
60  _______________________________________________________1111111111111111111111111111111111111111_________________________________________________________________
61  _______________________________________________________1______________________________________1_________________________________________________________________
62  _______________________________________________________1______________________________________1_________________________________________________________________
63  _______________________________________________________1______________________________________1_________________________________________________________________
64  _______________________________________________________1111111111111111111111111111111111111111_________________________________________________________________
65  ________________________________________________________________________________________________________________________________________________________________
66  ________________________________________________________________________________________________________________________________________________________________
67  ________________________________________________________________________________________________________________________________________________________________
68  ________________________________________________________________________________________________________________________________________________________________
69  ________________________________________________________________________________________________________________________________________________________________
70  ________________________________________________________________________________________________________________________________________________________________
71  ________________________________________________________________________________________________________________________________________________________________
72  ________________________________________________________________________________________________________________________________________________________________
73  ________________________________________________________________________________________________________________________________________________________________
74  ________________________________________________________________________________________________________________________________________________________________
75  ________________________________________________________________________________________________________________________________________________________________
76  _____________________________________________________________________________________________________________________________111111_____________________________
77  ___________________________________________________________________________________________________________________________11______1111111______________________
78  _________________________________________________________________________________________________________________________11_______________11____________________
79  _______________________________________________________________________________________________________________________11___________________11__________________
80  _____________________________________________________________________________________________________________________11_______________________11________________
81  ___________________________________________________________________________________________________________________11___________________________1_______________
82  __________________________________________________________________________________________________________________1_____________________________1_______________
83  _________________________________________________________________________________________________________________1______________________________11______________
84  ________________________________________________________________________________________________________________11___________________________111________________
85  ________________________________________________________________________________________________________________111_______________________111___________________
86  ___________________________________________________________________________________________________________________111111_________11111111______________________
87  _________________________________________________________________________________________________________________________111111111______________________________
88  ________________________________________________________________________________________________________________________________________________________________
89  ________________________________________________________________________________________________________________________________________________________________
90  ________________________________________________________________________________________________________________________________________________________________
91  ________________________________________________________________________________________________________________________________________________________________
92  ________________________________________________________________________________________________________________________________________________________________
93  ________________________________________________________________________________________________________________________________________________________________
94  ________________________________________________________________________________________________________________________________________________________________
95  ________________________________________________________________________________________________________________________________________________________________
96  _1111111111111111111111111111111111111111111111111111111111111111111111111______________________________________________________________________________________
97  _1___1___1___1___1___1___1___1____1___1___________________________________11____________________________________________________________________________________
98  _1___1___1___1___1___1___1___1____1___1_____________________________________1___________________________________________________________________________________
99  _1___1___1___1___1___1___1___1____1___1______________________________________11_________________________________________________________________________________
100 _1___1___1___1___1___1___1___1____1___1________________________________________1________________________________________________________________________________
101 _1___1___1___1___1___1___1___1____1___1_________________________________________11______________________________________________________________________________
102 _1___1___1___1___1___1___1___1____1___1___________________________________________1_____________________________________________________________________________
103 _11111___1___1___1___1___1___1____1___1____________________________________________11______________________________________________1111111111111111111111111111_
104 ______1111___1___1___1___1___1____1___1______________________________________________1___________________________________________111___1___1___1___1___1___1__1_
105 ________11___1___1___1___1___1____1___1_______________________________________________11________________________________________1__1___1___1___1___1___1___1__1_
106 ________11___1___1___1___1___1____1___1_________________________________________111111111_____________________________________11___1___1___1___1___1___1___1__1_
107 ________11___1___1___1___1___1____1___1_________________________________________1________11_________________________________11_____1___1___1___1___1___1___1__1_
108 ________11___1___1___1___1___1____1___1_________________________________________1__________1111111111111111111_____________1_______1___1___1___1___1___1___1__1_
109 ________11___1___1___1___1___1____1___1_________________________________________1___________11_______________1______________1______1___1___1111111111111___1__1_
110 _________1___1___1___1___1___1____1___1_________________________________________1_____________1______________1_______________1_____11111111___________111111111_
111 _________1___1___1___1___1___1____1___1__________________________________________1_____________11____________1________________1__11111__________________________
112 _________1___1___1___1___1___1____1___1__________________________________________1______________11___________1________________111_______________________________
113 __________1__1___1___1___1___1____1___1___________________________________________1______________11__________1__________________________________________________
114 __________1__1___1___1___1___1____1___1___________________________________________1________________11________1__________________________________________________
115 __________1__1___1___1___1___1____1___1____________________________________________1________________11_______1__________________________________________________
116 ___________1_1___1___1___1___1____1___1_____________________________________________1_________________11_____1__________________________________________________
117 ___________1_1___1___1___1___1____1___1_____________________________________________1___________________1____1__________________________________________________
118 ___________1_1___11111___1___1____1___1______________________________________________1___________________11__1__________________________________________________
119 ____________11111111111111___1____1___1______________________________________________1_____________________1_1__________________________________________________
120 ____________1____1___1111111_1____1___1_______________________________________________11111111111___________11111111111111111___________________________________
121 ____________1____1_________1_1____1___1_________________________________________________________1_____________11____________1___________________________________
122 _____________1___1__________11____1___1_________________________________________________________1______________11___________11__________________________________
123 _____________1___1__________11____1___1_________________________________________________________1________________1___________1__________________________________
124 _____________1___1__________11____1___1________________________________________________1111111111_________________11_________1__________________________________
125 ______________1__1___________1____1___1_____________________________1111111111111111111_____________________________1________1__________________________________
126 ______________1__1___________1____1___1___________________1111111111_1_______________________________________________11______1__________________________________
127 ______________1__1___________1____1___1_________________11111111111111_________________________________________________1_____1__________________________________
128 _______________1_1____________1___1___1_____1111111111111111111_________________________________________________________11___1__________________________________
129 _______________1_1____________1___1___1______11111________________________________________________________________________1__1__________________________________
130 ________________11____________1___1___1_11111______________________________________________________________________________111__________________________________
131 ________________11111111_______1__111111____________________________________________________________________________________11__________________________________
132 ________________1____1_1_______111_________________________________________________________________111111111111111111111111111__________________________________
133 _________________1___1_1___________________________________________________________________________1________________1111________________________________________
134 _________________1___1_1___________________________________________________________________________1____________1111____________________________________________
135 _________________1___1_1___________________________________________________________________________1________1111________________________________________________
136 __________________1__1_1___________________________________________________________________________1____1111____________________________________________________
137 __________________1__1_1___________________________________________________________________________11111________________________________________________________
138 __________________1__1_1________________________________________________________________________1111____________________________________________________________
139 ___________________1_1_1____________________________________________________________________1111___1____________________________________________________________
140 ___________________1_1_1________________________________________________________________1111_______1____________________________________________________________
141 ___________________1_1_1____________________________________________________________1111___________1____________________________________________________________
142 ____________________11_1________________________________________________________1111_______________1____________________________________________________________
143 ____________________11_1______________________________________________________1111111111111111111111____________________________________________________________
144 ____________________11_111111111111111111111____________________________________________________________________________________________________________________
145 _____________________1_____________________1____________________________________________________________________________________________________________________
146 _____________________1_____________________1____________________________________________________________________________________________________________________
147 _____________________1_____________________1____________________________________________________________________________________________________________________
148 ______________________1__________11111111111____________________________________________________________________________________________________________________
149 ______________________11111111111_______________________________________________________________________________________________________________________________
150 ________________________________________________________________________________________________________________________________________________________________
151 ________________________________________________________________________________________________________________________________________________________________
152 ________________________________________________________________________________________________________________________________________________________________
153 ________________________________________________________________________________________________________________________________________________________________
154 ________________________________________________________________________________________________________________________________________________________________
155 ________________________________________________________________________________________________________________________________________________________________
156 ________________________________________________________________________________________________________________________________________________________________
157 ________________________________________________________________________________________________________________________________________________________________
158 ________________________________________________________________________________________________________________________________________________________________
159 ________________________________________________________________________________________________________________________________________________________________
160 ________________________________________________________________________________________________________________________________________________________________
161 ________________________________________________________________________________________________________________________________________________________________
162 ________________________________________________________________________________________________________________________________________________________________
163 ________________________________________________________________________________________________________________________________________________________________
164 ________________________________________________________________________________________________________________________________________________________________
165 ________________________________________________________________________________________________________________________________________________________________
166 ________________________________________________________________________________________________________________________________________________________________
167 ________________________________________________________________________________________________________________________________________________________________
