    0         10        20        30        40        50        60        70        80        90        100       110       120       130       140       150       
    0123456789012345678901234567890123456789012345678901234567890123456789012345678901234567890123456789012345678901234567890123456789012345678901234567890123456789
0   ________________________________________________________________________________________________________________________________________________________________
1   ________________________________________________________________________________________________________________________________________________________________
2   ________________________________________________________________________________________________________________________________________________________________
3   ________________________________________________________________________________________________________________________________________________________________
4   ________________________________________________________________________________________________________________________________________________________________
5   ________________________________________________________________________________________________________________________________________________________________
6   ________________________________________________________________________________________________________________________________________________________________
7   ________________________________________________________________________________________________________________________________________________________________
8   ________________________________________________________________________________________________________________________________________________________________
9   ________________________________________________________________________________________________________________________________________________________________
10  ________________________________________________________________________________________________________________________________________________________________
11  ________________________________________________________________________________________________________________________________________________________________
12  ________________________________________________________________________________________________________________________________________________________________
13  ________________________________________________________________________________________________________________________________________________________________
14  ________________________________________________________________________________________________________________________________________________________________
15  ________________________________________________________________________________________________________________________________________________________________
16  ________________________________________________________________________________________________________________________________________________________________
17  ________________________________________________________________________________________________________________________________________________________________
18  ________________________________________________________________________________________________________________________________________________________________
19  ________________________________________________________________________________________________________________________________________________________________
20  ________________________________________________________________________________________________________________________________________________________________
21  ________________________________________________________________________________________________________________________________________________________________
22  ________________________________________________________________________________________________________________________________________________________________
23  ________________________________________________________________________________________________________________________________________________________________
24  ________________________________________________________________________________________________________________________________________________________________
25  ________________________________________________________________________________________________________________________________________________________________
26  ________________________________________________________________________________________________________________________________________________________________
27  ________________________________________________________________________________________________________________________________________________________________
28  ________________________________________________________________________________________________________________________________________________________________
29  ________________________________________________________________________________________________________________________________________________________________
30  ________________________________________________________________________________________________________________________________________________________________
31  ________________________________________________________________________________________________________________________________________________________________
32  ________________________________________________________________________________________________________________________________________________________________
33  ___1____________________________________________________________________________________________________________________________________________________________
34  __1_____________________________________________________________________________________________________________________________________________________________
35  __1_____________________________________________________________________________________________________________________________________________________________
36  _1______________________________________________________________________________________________________________________________________________________________
37  _1______________________________________________________________________________________________________________________________________________________________
38  _1______________________________________________________________________________________________________________________________________________________________
39  _1______________________________________________________________________________________________________________________________________________________________
40  ________________________________________________________________________________________________________________________________________________________________
41  ________________________________________________________________________________________________________________________________________________________________
42  ________________________________________________________________________________________________________________________________________________________________
43  ________________________________________________________________________________________________________________________________________________________________
44  ________________________________________________________________________________________________________________________________________________________________
45  ________________________________________________________________________________________________________________________________________________________________
46  ________________________________________________________________________________________________________________________________________________________________
47  ________________________________________________________________________________________________________________________________________________________________
48  ________________________________________________________________________________________________________________________________________________________________
49  ________________________________________________________________________________________________________________________________________________________________
50  ________________________________________________________________________________________________________________________________________________________________
51  ________________________________________________________________________________________________________________________________________________________________
52  ________________________________________________________________________________________________________________________________________________________________
53  ________________________________________________________________________________________________________________________________________________________________
54  ________________________________________________________________________________________________________________________________________________________________
55  ________________________________________________________________________________________________________________________________________________________________
56  ________________________________________________________________________________________________________________________________________________________________
57  ________________________________________________________________________________________________________________________________________________________________
58  ________________________________________________________________________________________________________________________________________________________________
59  ________________________________________________________________________________________________________________________________________________________________
60  ________________________________________________________________________________________________________________________________________________________________
61  ________________________________________________________________________________________________________________________________________________________________
62  ________________________________________________________________________________________________________________________________________________________________
63  ________________________________________________________________________________________________________________________________________________________________
64  ________________________________________________________________________________________________________________________________________________________________
65  ________________________________________________________________________________________________________________________________________________________________
66  ________________________________________________________________________________________________________________________________________________________________
67  ____________________________________11111_______________________________________________________________________________________________________________________
68  ____________________________________1___1_______________________________________________________________________________________________________________________
69  ____________________________________1___1_______________________________________________________________________________________________________________________
70  ____________________________11111___1___1_______________________________________________________________________________________________________________________
71  ____________________11111___1___1___1___1___________________________________________________11111___1___________________________________________________________
72  ____________________1___1___1___1___1___1___________________________________________________1___1___1___________________________________________________________
73  ____________________1___1___1___1___1___1___________________________________________________1___1___1___________________________________________________________
74  ____________________1___1___1___1___1___1___________________________________11111___________1___1___1___________________________________________________________
75  ____________________1___1___1___1___1___1___11111___________________________1___1___________1___1___1___________________________________________________________
76  ____________________1___1___1___1___1___1___1___1___________________________1___1___________1___1___1___________________________________________________________
77  ____________________1___1___1___1___1___1___1___1___________________________1___1___11111___1___1___1___________________________________________________________
78  ____________________1___1___1___1___1___1___1___1___________________________1___1___1___1___1___1___1___________________________________________________________
79  ____________________1___1___1___1___1___1___1___1___________________________1___1___1___1___1___1___1___________________________________________________________
80  ____________________1___1___1___1___1___1___1___1___________________________1___1___1___1___1___1___1___________________________________________________________
81  ____________________1___1___1___1___1___1___1___1___________________________1___1___1___1___1___1___1___________________________________________________________
82  ____________________1___1___1___1___1___1___1___1___________________________1___1___1___1___1___1___1___________________________________________________________
83  ____________________1___1___1___1___1___1___1___1___________________________1___1___1___1___1___1___1___________________________________________________________
84  ____________________1___1___1___1___1___1___1___1___11111___________________1___1___1___1___1___1___1___________________________________________________________
85  ____________________1___1___1___1___1___1___1___1___1___1___________________1___1___1___1___1___1___1___________________________________________________________
86  ____________________1___1___1___1___1___1___1___1___1___1___________________1___1___1___1___1___1___1___________________________________________________________
87  ____________________1___1___1___1___1___1___1___1___1___1___________________1___1___1___1___1___1___1___________________________________________________________
88  ____________________1___1___1___1___1___1___1___1___1___1___________________1___1___1___1___1___1___1___________________________________________________________
89  ___________11111____1___1___1___1___1___1___1___1___1___1___________________1___1111111111111___1___1___________________________________________________________
90  ___________1___1____1___1___1___1___1___1___1___1___1___1___________________1__11____________1111111111111______________________________________________________
91  ___________1___1____1___1___1___1___1___1___1___1___1___1___________________111___________________________1_____________________________________________________
92  ___________1___1____1___1___1___1___11__1___1___1___1___1___________________1_____________________________1_____________________________________________________
93  ___________1___1____1___1___1___1___111_1___1___1___1___1_________________11_______________________________1____________________________________________________
94  ___________1___1____1___1___1___1___11_11___1___1___1___1_______________11_________________________________1____________________________________________________
95  ___________1___1____1___1___1___1___1___1___1___1___1___1______________1____________________________________1___________________________________________________
96  ___________1___1____1___1___1___1___1___11111___1___1___1____________11_____________________________________1___________________________________________________
97  ___________1___1____1___1___1___1__1______111___1___1___1__________11________________________________________1__________________________________________________
98  ___________1___1____1___1___1___1__1_________11111111___1_________1__________________________________________1__________________________________________________
99  ___________1___1____1___1___1___1_1_______________1111__1_______11____________________________________________111111111_________________________________________
100 ___________1___1____1___1___1___11____________________11111___11_______________________________________________________1111111111_______________________________
101 ___________1___1____1___1___1___11_________________________111__________________________________________________________________1_______________________________
102 ___________1___1____1___1___1___1________________________________________________________________________________________________1______________________________
103 ___________1___1____1___1___1__1_________________________________________________________________________________________________1______________________________
104 ___________1___1____1___1___1__1_________________________________________________11111111111______________________________________1_____________________________
105 ___________1___1____1___1___1_1________________________________________________11___________111___________________________________1_____________________________
106 ___________1___1____1___1___11_______________________________________________11_______________1____________________________________1____________________________
107 ___________1___1____1___1___11_______________________________________________11_______________11___________________________________1____________________________
108 ___________1___1____1___1___1__________________________________________________11___________11______________________________________1___________________________
109 ___________1___1____1___1___11___________________________________________________11_______11________________________________________1___________________________
110 ___________1___1____1___1___11_____________________________________________________1111111___________________________________________1__________________________
111 ___________1___1____1___1___1_1______________________________________________________________________________________________________1__________________________
112 ___________1___1____1___1___1_1______________________________________________________________________________________________________1__________________________
113 ___________1___1____1___1___1_1_______________________________________________________________________________________________________1_________________________
114 ___________1___1____1___1___1_1_______________________________________________________________________________________________________1_________________________
115 ___________1___1____1___1___1__1_______________________________________________________________________________________________________1________________________
116 ___________1___1____1___1___1__1_______________________________________________________________________________________________________1________________________
117 ___________1___1____1___1___1__1________________________________________________________________________________________________________1_______________________
118 ___________1___1____1___1___1__1________________________________________________________________________________________________________1_______________________
119 ___________1___1____1___1___1__1_________________________________________________________________________________________________________1______________________
120 ___________1___1____1___1___1__1_________________________________________________________________________________________________________1______________________
121 ___________1___1____1___1___1___1_________________________________________________________________________________________________________1_________11111111111_
122 ___________1___1____1__111111___1_________________________________________________________________________________________________________1111111111____________
123 ___________1___1____1_1_____11111________________________________________________________________________________________________________________1______________
124 ___________1___1_____1___________________________________________________________________________________________________________________________1______________
125 ___________1___1____1_____________________________________________________________________________________________________________________________1_____________
126 ___________1___1___1______________________________________________________________________________________________________________________________1_____________
127 1111111111111111111________________________________________________________________________________________________________________________________1____________
128 ___________________________________________________________________________________________________________________________________________________1____________
129 ___________________________________________________________________________________________________________________________________________________1____________
130 ____________________________________________________________________________________________________________________________________________________1___________
131 ____________________________________________________________________________________________________________________________________________________1___________
132 ____________________________________________________________________________________________________________________________________________________1___________
133 _____________________________________________________________________________________________________________________________________________________1__________
134 _____________________________________________________________________________________________________________________________________________________1__________
135 ______________________________________________________________________________________________________________________________________________________1_________
136 ______________________________________________________________________________________________________________________________________________________1_________
137 ______________________________________________________________________________________________________________________________________________________111111111_
138 ______________________________________________________________________________________________________________________________________________________1_________
139 ______________________________________________________________________________________________________________________________________________________1_________
140 ______________________________________________________________________________________________________________________________________________________1_________
141 ______________________________________________________________________________________________________________________________________________________1_________
142 _______________________________________________________________________________________________________________________________________________________1________
143 _______________________________________________________________________________________________________________________________________________________1________
144 _______________________________________________________________________________________________________________________________________________________1________
145 _______________________________________________________________________________________________________________________________________________________1________
146 _______________________________________________________________________________________________________________________________________________________1________
147 _______________________________________________________________________________________________________________________________________________________1________
148 ________________________________________________________________________________________________________________________________________________________1_______
149 ________________________________________________________________________________________________________________________________________________________1_______
150 ________________________________________________________________________________________________________________________________________________________1_______
151 ________________________________________________________________________________________________________________________________________________________1_______
152 11111111111111111111111111111111________________________________________________________________________________________________________________________1_______
153 ________________________________111_____________________________________________________________________________________________________________________1_______
154 __________________________________1______________________________________________________________________________________________________________________1______
155 ___________________________________1_____________________________________________________________________________________________________________________1______
156 ___________________________________1____________________11111111111______________________________________________________________________________________1______
157 ___________________________________1____________________1__________1_____________________________________________________________________________________1______
158 ___________________________________1___________________1___________1_____________________________________________________________________________________1______
159 ____________________________________1_________________1____________1____________________________________________________________________________________1_______
160 ____________________________________1________________1______________1___________________________________________________________________________________1_______
161 _____________________________________11______________1_______________1_________________________________________________________________________________1________
162 _______________________________________1____________1_________________1________________________________________________________________________________1________
163 ________________________________________11__________11_________________11_____________________________________________________________________________1_________
164 __________________________________________1___________11______________11______________________________________________________________________________1_________
165 ___________________________________________11___________11__________11_______________________________________________________________________________1__________
166 __________________________________________1111____________1111111111_________________________________________________________________________________1__________
167 ______________________________________________1______________________________________________________________________________________________________1__________
