    0         10        20        30        40        50        60        70        80        90        100       110       120       130       140       150       
    0123456789012345678901234567890123456789012345678901234567890123456789012345678901234567890123456789012345678901234567890123456789012345678901234567890123456789
0   ________________________________________________________________________________________________________________________________________________________________
1   ________________________________________________________________________________________________________________________________________________________________
2   ________________________________________________________________________________________________________________________________________________________________
3   ________________________________________________________________________________________________________________________________________________________________
4   ________________________________________________________________________________________________________________________________________________________________
5   ________________________________________________________________________________________________________________________________________________________________
6   ________________________________________________________________________________________________________________________________________________________________
7   ________________________________________________________________________________________________________________________________________________________________
8   ________________________________________________________________________________________________________________________________________________________________
9   ________________________________________________________________________________________________________________________________________________________________
10  ________________________________________________________________________________________________________________________________________________________________
11  ________________________________________________________________________________________________________________________________________________________________
12  ________________________________________________________________________________________________________________________________________________________________
13  ________________________________________________________________________________________________________________________________________________________________
14  ________________________________________________________________________________________________________________________________________________________________
15  ________________________________________________________________________________________________________________________________________________________________
16  ________________________________________________________________________________________________________________________________________________________________
17  ________________________________________________________________________________________________________________________________________________________________
18  ________________________________________________________________________________________________________________________________________________________________
19  ________________________________________________________________________________________________________________________________________________________________
20  ________________________________________________________________________________________________________________________________________________________________
21  ________________________________________________________________________________________________________________________________________________________________
22  ________________________________________________________________________________________________________________________________________________________________
23  ________________________________________________________________________________________________________________________________________________________________
24  ________________________________________________________________________________________________________________________________________________________________
25  ________________________________________________________________________________________________________________________________________________________________
26  ________________________________________________________________________________________________________________________________________________________________
27  ________________________________________________________________________________________________________________________________________________________________
28  __________________________________________________________________33____________________________________________________________________________________________
29  __________________________________________________________________33____________________________________________________________________________________________
30  __________________________________________________________________333___________________________________________________________________________________________
31  __________________________________________________________________333___________________________________________________________________________________________
32  __________________________________________________________________333___________________________________________________________________________________________
33  _________________________________________________________________3333___________________________________________________________________________________________
34  ________________________________________________________________33333___________________________________________________________________________________________
35  _______________________________________________________________33333____________________________________________________________________________________________
36  _____________________________________________________________3333_3_____________________________________________________________________________________________
37  __________________________________________________________3333333_______________________________________________________________________________________________
38  ____________________________________________________3333333333333_______________________________________________________________________________________________
39  __________________________________________________333333333333__________________________________________________________________________________________________
40  ____________________________________________3333333333333333____________________________________________________________________________________________________
41  __________________________________________333333333333333333____________________________________________________________________________________________________
42  ________________________________________3333333333333333333333__________________________________________________________________________________________________
43  ______________________________________33333333333333333333333333________________________________________________________________________________________________
44  ____________________________________3333333333333333333333333333________________________________________________________________________________________________
45  __________________________________33333333333___33333333333333333_______________________________________________________________________________________________
46  ________________________________________________________________________________________________________________________________________________________________
47  ________________________________________________________________________________________________________________________________________________________________
48  ________________________________________________________________________________________________________________________________________________________________
49  ________________________________________________________________________________________________________________________________________________________________
50  _____________________________3333333333333333___333333333333333333______________________________________________________________________________________________
51  ____________________________33333333333333333___333333333333333333______________________________________________________________________________________________
52  ____________________________33333333333333333___3333333333333333333_____________________________________________________________________________________________
53  ___________________________333333333333333333___3333333333333333333_____________________________________________________________________________________________
54  __________________________3333333333333333333___33333333333333333333____________________________________________________________________________________________
55  _________________________33333333333333333333___33333333333333333333____________________________________________________________________________________________
56  ____________________111111111111111111111111111111111_11_11111111111111111________________________________11111111111111111_____________________________________
57  ____________________1_______1________1________1_____1____________________1_____________________________111_________________11___________________________________
58  ____________________1_______1________1________1_____1____________________1___________________________11______________________11_________________________________
59  _____________________11111111111111111111111111111111_111_1111111111111111_________________________111________________________111_______________________________
60  ____________________________________________________11111_____________________________________________11__________________1111__________________________________
61  ____________________________________________________11111_______________________________________________111111111111111111______________________________________
62  ____________________________________________________11111_______________________________________________________________________________________________________
63  ____________________________________________________11111_______________________________________________________________________________________________________
64  ____________________________________________________11111_______________________________________________________________________________________________________
65  ____________________________________________________11111_______________________________________________________________________________________________________
66  ____________________________________________________11111_______________________________________________________________________________________________________
67  ____________________________________________________11111_______________________________________________________________________________________________________
68  ____________________________________________________11111_______________________________________________________________________________________________________
69  ____________________________________________________11111_______________________________________________________________________________________________________
70  ____________________________________________________11111_______________________________________________________________________________________________________
71  ____________________________________________________11111_______________________________________________________________________________________________________
72  ____________________________________________________11111_______________________________________________________________________________________________________
73  ____________________________________________________11111_______________________________________________________________________________________________________
74  ____________________________________________________11111_______________________________________________________________________________________________________
75  ____________________________________________________11111_______________________________________________________________________________________________________
76  ____________________________________________________11111_______________________________________________________________________________________________________
77  ____________________________________________________11111_______________________________________________________________________________________________________
78  ____________1_111111111111111111111111111111111111111111111111111111111111111_11________________________________________________________________________________
79  ____________1_________1_________1________1__________1__________________________1________________________________________________________________________________
80  ____________1_________1_________1________1__________1__________________________1________________________________________________________________________________
81  ____________1_________1_________1________1__________1__________________________1________________________________________________________________________________
82  ____________1__3______1_________1________1__________1__________________________1________________________________________________________________________________
83  ____________111111111111111111111111111111111111111111111111111111111111111111_1________________________________________________________________________________
84  _______________33_______________________________________________________________________________________________________________________________________________
85  _______________333_________________________________________________________3____________________________________________________________________________________
86  ________________33_________________________________________________________3____________________________________________________________________________________
87  ________________333_______________________________________________________33____________________________________________________________________________________
88  ________________333333333333333333333333333____3333333333333333333333333333_____________________________________________________________________________________
89  ________________333333333333333333333333333____3333333333333333333333333333_____________________________________________________________________________________
90  ________________333333333333333333333333333____3333333333333333333333333333_____________________________________________________________________________________
91  ________________333333333333333333333333333____33333333333333333333333333333____________________________________________________________________________________
92  ________________333333333333333333333333333____33333333333333333333333333333____________________________________________________________________________________
93  ________________333333333333333333333333333____33333333333333333333333333333____________________________________________________________________________________
94  _________________33333333333333333333333333____33333333333333333333333333333____________________________________________________________________________________
95  _________________33333333333333333333333333____33333333333333333333333333333____________________________________________________________________________________
96  _________________33333333333333333333333333____33333333333333333333333333333____________________________________________________________________________________
97  _________________33333333333333333333333333____333333333333333333333333333333___________________________________________________________________________________
98  _________________33333333333333333333333333____333333333333333333333333333333___________________________________________________________________________________
99  _________________33333333333333333333333333____333333333333333333333333333333___________________________________________________________________________________
100 ________________333333333333333333333333333____333333333333333333333333333333___________________________________________________________________________________
101 ________________333333333333333333333333333____333333333333333333333333333333___________________________________________________________________________________
102 _______________3333333333333333333333333333____333333333333333333333333333333___________________________________________________________________________________
103 _______________3333333333333333333333333333____333333333333333333333333333333___________________________________________________________________________________
104 _______________3333333333333333333333333333____333333333333333333333333333333___________________________________________________________________________________
105 ______________33333333333333333333333333333____333333333333333333333333333333___________________________________________________________________________________
106 ______________33333333333333333333333333333____333333333333333333333333333333___________________________________________________________________________________
107 ______________33333333333333333333333333333____333333333333333333333333333333___________________________________________________________________________________
108 _____________333333333333333333333333333333____333333333333333333333333333333___________________________________________________________________________________
109 _____________333333333333333333333333333333____33333333333333333333333333333____________________________________________________________________________________
110 ____________3333333333333333333333333333333____33333333333333333333333333333____________________________________________________________________________________
111 ____________3333333333333333333333333333333____33333333333333333333333333333____________________________________________________________________________________
112 ____________3333333333333333333333333333333____33333333333333333333333333333____________________________________________________________________________________
113 _____________333333333333333333333333333333____333333333333333333333333333333___________________________________________________________________________________
114 _____________333333333333333333333333333333____3333333333333333333333333333333__________________________________________________________________________________
115 ______________33333333333333333333333333333____33333333333333333333333333333333_________________________________________________________________________________
116 ______________333333333333333333333333333333__3333333333333333333333333333333333________________________________________________________________________________
117 ______________333333333333333333333333333333__3333333333333333333333333333333333________________________________________________________________________________
118 _______________33333333333333333333333333333333333333333333333333333333333333333________________________________________________________________________________
119 _______________33333333333333333333333333333333333333333333333333333333333333333________________________________________________________________________________
120 _______________33333333333333333333333333333333333333333333333333333333333333333________________________________________________________________________________
121 ________________3333333333333333333333333333333333333333333333333333333333333333________________________________________________________________________________
122 ________________3333333333333333333333333333333333333333333333333333333333333333________________________________________________________________________________
123 _________________333333333333333333333333333333333333333333333333333333333333333________________________________________________________________________________
124 _________________3333333333333333333333333333333333333333333333333333333333333333_______________________________________________________________________________
125 _________________3333333333333333333333333333333333333333333333333333333333333333_______________________________________________________________________________
126 ________________33333333333333333333333333333333333333333333333333333333333333333_______________________________________________________________________________
127 ________________33333333333333333333333333333333333333333333333333333333333333333_______________________________________________________________________________
128 ________________333333333333333333333333333333333333333333333333333333333333333333______________________________________________________________________________
129 _______________3333333333333333333333333333333333333333333333333333333333333333333______________________________________________________________________________
130 _______________3333333333333333333333333333333333333333333333333333333333333333333______________________________________________________________________________
131 _______________33333333333333333333333333333333333333333333333333333333333333333333_____________________________________________________________________________
132 _______________33333333333333333333333333333333333333333333333333333333333333333333_____________________________________________________________________________
133 ______________333333333333333333333333333333333333333333333333333333333333333333333_____________________________________________________________________________
134 ______________33333333333333333333333333333333333333333333333333333333333333333333______________________________________________________________________________
135 ______________33333333333333333333333333333333333333333333333333333333333333333333______________________________________________________________________________
136 _____________33333333333333333333333333333333333333333333333333333333333333333333_______________________________________________________________________________
137 _____________33333333333333333333333333333333333333333333333333333333333333333333_______________________________________________________________________________
138 _____________33333333333333333333333333333333333333333333333333333333333333333333_______________________________________________________________________________
139 _____________333333333333333333333333333333333333333333333333333333333333333333333______________________________________________________________________________
140 _____________333333333333333333333333333333333333333333333333333333333333333333333______________________________________________________________________________
141 _____________3333333333333333333333333333333333333333333333333333333333333333333333_____________________________________________________________________________
142 _____________3333333333333333333333333333333333333333333333333333333333333333333333_____________________________________________________________________________
143 _____________333333333333333333333333333333333333333333333333333333333333333333333______________________________________________________________________________
144 _____________333333333333333333333333333333333333333333333333333333333333333333333______________________________________________________________________________
145 _____________33333333333333333333333333333333333333333333333333333333333333333333_______________________________________________________________________________
146 ____________333333333333333333333333333333333333333333333333333333333333333333333_______________________________________________________________________________
147 ____________3333333333333333333333333333333333333333333333333333333333333333333333______________________________________________________________________________
148 ___________333333333333333333333333333333333333333333333333333333333333333333333333_____________________________________________________________________________
149 ___________3333333333333333333333333333333333333333333333333333333333333333333333333____________________________________________________________________________
150 ___________33333333333333333333333333333333333333333333333333333333333333333333333333___________________________________________________________________________
151 ____________33333333333333333333333333333333333333333333333333333333333333333333333333__________________________________________________________________________
152 ____________33333333333333333333333333333333333333333333333333333333333333333333333333__________________________________________________________________________
153 ____________333333333333333333333333333333333333333333333333333333333333333333333333333_________________________________________________________________________
154 ____________333333333333333333333333333333333333333333333333333333333333333333333333333_________________________________________________________________________
155 ___________33333333333333333333333333333333333333333333333333333333333333333333333333333________________________________________________________________________
156 ___________33333333333333333333333333333333333333333333333333333333333333333333333333333________________________________________________________________________
157 __________3333333333333333333333333333333333333333333333333333333333333333333333333333333_______________________________________________________________________
158 __________3333333333333333333333333333333333333333333333333333333333333333333333333333333_______________________________________________________________________
159 _________33333333333333333333333333333333333333333333333333333333333333333333333333333333_______________________________________________________________________
160 ________333333333333333333333333333333333333333333333333333333333333333333333333333333333_______________________________________________________________________
161 ________3333333333333333333333333333333333333333333333333333333333333333333333333333333333______________________________________________________________________
162 _______33333333333333333333333333333333333333333333333333333333333333333333333333333333333______________________________________________________________________
163 _______333333333333333333333333333333333333333333333333333333333333333333333333333333333333_____________________________________________________________________
164 ______3333333333333333333333333333333333333333333333333333333333333333333333333333333333333_____________________________________________________________________
165 ______33333333333333333333333333333333333333333333333333333333333333333333333333333333333333____________________________________________________________________
166 _____333333333333333333333333333333333333333333333333333333333333333333333333333333333333333____________________________________________________________________
167 ________________________________________________________________________________________________________________________________________________________________
