    0         10        20        30        40        50        60        70        80        90        100       110       120       130       140       150       
    0123456789012345678901234567890123456789012345678901234567890123456789012345678901234567890123456789012345678901234567890123456789012345678901234567890123456789
0   ________________________________________________________________________________________________________________________________________________________________
1   ______1111111111________________________________________________________________________________________________________________________________________________
2   ______1111111111________________________________________________________________________________________________________________________________________________
3   ______1111111111________________________________________________________________________________________________________________________________________________
4   ______1111111111________________________________________________________________________________________________________________________________________________
5   ______1111111111________________________________________________________________________________________________________________________________________________
6   ______1111111111________________________________________________________________________________________________________________________________________________
7   ______1111111111________________________________________________________________________________________________________________________________________________
8   ______1111111111________________________________________________________________________________________________________________________________________________
9   ______1111111111________________________________________________________________________________________________________________________________________________
10  ______1111111111________________________________________________________________________________________________________________________________________________
11  ______1111111111________________________________________________________________________________________________________________________________________________
12  ______1111111111________________________________________________________________________________________________________________________________________________
13  ______1111111111________________________________________________________________________________________________________________________________________________
14  ______1111111111________________________________________________________________________________________________________________________________________________
15  ______1111111111________________________________________________________________________________________________________________________________________________
16  ______1111111111________________________________________________________________________________________________________________________________________________
17  ______1111111111________________________________________________________________________________________________________________________________________________
18  ______1111111111________________________________________________________________________________________________________________________________________________
19  ______1111111111________________________________________________________________________________________________________________________________________________
20  ______1111111111________________________________________________________________________________________________________________________________________________
21  ______1111111111________________________________________________________________________________________________________________________________________________
22  ______1111111111________________________________________________________________________________________________________________________________________________
23  ______1111111111________________________________________________________________________________________________________________________________________________
24  ______1111111111________________________________________________________________________________________________________________________________________________
25  ______1111111111________________________________________________________________________________________________________________________________________________
26  ______1111111111________________________________________________________________________________________________________________________________________________
27  ______1111111111________________________________________________________________________________________________________________________________________________
28  ______1111111111________________________________________________________________________________________________________________________________________________
29  ______1111111111________________________________________________________________________________________________________________________________________________
30  ______1111111111________________________________________________________________________________________________________________________________________________
31  ______1111111111________________________________________________________________________________________________________________________________________________
32  ______1111111111________________________________________________________________________________________________________________________________________________
33  ______1111111111________________________________________________________________________________________________________________________________________________
34  ______1111111111________________________________________________________________________________________________________________________________________________
35  ______1111111111___________________________________333__________________________________________________________________________________________________________
36  ______1111111111____________________________________333_________________________________________________________________________________________________________
37  ______1111111111__________________________________333333________________________________________________________________________________________________________
38  ______1111111111______________________________3333333333________________________________________________________________________________________________________
39  ______1111111111___________________________333333333333_________________________________________________________________________________________________________
40  ______1111111111_________________________33333333333333_________________________________________________________________________________________________________
41  ______1111111111______________333333333333333333333333___1111111111111111111111111111111111111111111111111111111111111111111111111111111111111111111111111111111
42  ______1111111111____________333333333333333333333333____1_______________________________________________________________________________________________________
43  ______1111111111________333333333333333333333333333____1________________________________________________________________________________________________________
44  ______1111111111______3333333333333333333333__3333____1_________________________________________________________________________________________________________
45  _______11111111_____333333_333333333333333_____33____1__________________________________________________________________________________________________________
46  11111111111111111111111111111111111111111111111111111___________________________________________________________________________________________________________
47  __________1111____33333333__3333___3333333_1____________________________________________________________________________________________________________________
48  ____________1_____3333333____333____333333_1_______________________________1111111111111111111111111111111111_________11111111111111111111111111111111111111____
49  _________________33333333____333_____33333_1_______________________________11___1___1___1___1___1___1___1___1_________1___1___1___1___1___1___1___1___1___1_1___
50  _________________33333333____33______33333_1_______________________________11___1___1___1___1___1___1___1___1_________1___1___1___1___1___1___1___1___1___1_1___
51  ________________333333333____33______33333_1_______________________________11___1___1___1___1___1___1___1___1_________1___1___1___1___1___1___1___1___1___1__1__
52  ________________333333333____33_____33_333_1_______________________________11___1___1___1___1___1___1___1___1_________1___1___1___1___1___1___1___1___1___1__1__
53  ________________333333333___3333__3333___3_1_______________________________11___111111111___1___1___1___1__11_________1___1___1___1___1___1___1___1___1___1__1__
54  _______________33333333333333333333333_____1________________________________111111______11111___1___1___111___________1___1___1___1___1___1___1___1___1___1__1__
55  ______________3333333333333333333333333____1_________________________________________________11111111111______________1___1___1___1___1___1___1___1___1___1__1__
56  _____________33333333333333333333333333____1__________________________________________________________________________111111111___1___1___1___1___1___1___1__1__
57  ____________333333333333333333333333333____1______________________________________________________________________________111111__1___1___1___1___1___1___1111__
58  ___________33333333_3333333333333333333____1_______1111111111___________________________________________________________________111111111111111___111111111_____
59  __________33333333__333333333333333333_____11111111__________11111_________________________________________________________________________111111111111_________
60  __________33333333__333333333333333333111111____________________11______________________________________________________________________________________________
61  _________33333333____33333333333333333____1111_______________111________________________________________________________________________________________________
62  _________33333333____33333333333333333________1111111______11___________________________________________________________________________________________________
63  _________33333333____3333333333333333________________111111_____________________________________________________________________________________________________
64  _________33333333____3333333333333333___________________________________________________________________________________________________________________________
65  _________33333333____3333333333333333___________________________________________________________________________________________________________________________
66  _________33333333__333333333333333333___________________________________________________________________________________________________________________________
67  _________3333333333333333333333333333___________________________________________________________________________________________________________________________
68  _________3333333333333333333333333333___________________________________________________________________________________________________________________________
69  _________3333333333333333333333333333___________________________________________________________________________________________________________________________
70  __________3333333333333333333333333333__________________________________________________________________________________________________________________________
71  __________33333333333333333333333333333_________________________________________________________________________________________________________________________
72  __________333333333333333333333333333333________________________________________________________________________________________________________________________
73  __________3333333333333333333333333333333_______________________________________________________________________________________________________________________
74  __________33333333333333333333333333333333______________________________________________________________________________________________________________________
75  ___________33333333333333333333333333333333_____________________________________________________________________________________________________________________
76  ___________3333333333333333333333333333333333___________________________________________________________________________________________________________________
77  ___________33333333333333333333333333333333333__________________________________________________________________________________________________________________
78  ___________3333333333333333333333333333333333333________________________________________________________________________________________________________________
79  ___________33333333333333333333333333333333333333_______________________________________________________________________________________________________________
80  ____________333333333333333333333333333333333333333________________________________4444444444___________________________________________________________________
81  ____________33333333333333333333333333333333333333333___________________________________________________________________________________________________________
82  _____________3333333333333333333333333333333333333333333________________________________________________________________________________________________________
83  _____________33333333333333333333333333333333333333333333_______________________________________________________________________________________________________
84  _____________3333333333333333333333333333333333333333333333_____________________________________________________________________________________________________
85  ______________33333333333333333333333333333333333333333333333___________________________________________________________________________________________________
86  ______________3333333333333333333333333333333333333333333333333_________________________________________________________________________________________________
87  ______________333333333333333333333333333333333333333333333333333_______________________________________________________________________________________________
88  _______________333333333333333333333333333333333333333333333333333______________________________________________________________________________________________
89  _______________333333333333333333333333333333333333333__333333333333____________________________________________________________________________________________
90  _______________33333333333333333333333333333333333333___33333333333333__________________________________________________________________________________________
91  ________________3333333333333333333333333333333333333____3333333333333333_______________________________________________________________________________________
92  ________________333333333333333333333333333333333333_____333333333333333333_____________________________________________________________________________________
93  _________________33333333333333333333333333333333333______3333333333333333333___________________________________________________________________________________
94  _________________33333333333333333333333333333333333______333333333333333333333_________________________________________________________________________________
95  __________________3333333333333333333333333333333333______33333333333333333333333_______________________________________________________________________________
96  __________________333333333333333333333333333333333_______3333333333333333333333333_____________________________________________________________________________
97  ___________________33333333333333333333333333333333________33333333333333333333333333___________________________________________________________________________
98  ___________________33333333333333333333333333333333________333333333333333333333333333__________________________________________________________________________
99  ____________________3333333333333333333333333333333______3333333333333333333333333333333________________________________________________________________________
100 ____________________3333333333333333333333333333333333333333333333333333333333333333333333______________________________________________________________________
101 _____________________33333333333333333333333333333333333333333333333333333333333333333333333____________________________________________________________________
102 ______________________333333333333333333333333333333333333333333333333333333333333333333333333__________________________________________________________________
103 _______________________3333333333333333333333333333333333333333333333333333333333333333333333333________________________________________________________________
104 ________________________3333333333333333333333333333333333333333333333333333333333333333333333333_______________________________________________________________
105 __________________________3333333333333333333333333333333333333333333333333333333333333333333333333_____________________________________________________________
106 ___________________________33333333333333333333333333333333333333333333333333333333333333333333333333___________1111111111111111111111111_______________________
107 ____________________________333333333333333333333333333333333333333333333333333333333333333333333333333_____1111________________________1_______________________
108 _____________________________3333333333333333333333333333333333333333333333333333333333333333333333333331111____________________________1_______________________
109 ______________________________3333333333333333333333333333333333333333333333333333333333333333333333333331______________________________1_______________________
110 _______________________________3333333333333333333333333333333333333333333333333333333333333333333333333331_____________________________1_______________________
111 _________________________________33333333333333333333333333333333333333333333333333333333333333333333333333111111111111111111111111111111_______________________
112 ___________________________________3333333333333333333333333333333333333333333333333333333333333333333333333____________________________________________________
113 ____________________________________33333333333333333333333333333333333333333333333333333333333333333333333333__________________________________________________
114 _____________________________________33333333333333333333333333333333333333333333333333333333333333333333333333_________________________________________________
115 _______________________________________3333333333333333333333333333333333333333333333333333333333333333333333333________________________________________________
116 ________________________________________33333333333333333333333333333333333333333333333333333333333333333333333333______________________________________________
117 _________________________________________333333333333333333333333333333333333333333333333333333333333333333333333333____________________________________________
118 ___________________________________________333333333333333333333333333333333333333333333333333333333333333333333333333__________________________________________
119 _____________________________________________333333333333333333333333333333333333333333333333333333333333333333333333333________________________________________
120 ______________________________________________3333333333333333333333333333333333333333333333333333333333333333333333333333______________________________________
121 __________________________________________________333333333333333333333333333333333333333333333333333333___33333333333333333____________________________________
122 ______________________________________________________3333333333333333333333333333333333333333333333333______33333333333333333__________________________________
123 ___________________________________________________________33333333333333333333333333333333333333333333_______333333333333333333________________________________
124 _______________________________________________________________3333333333333333333333333333333333333333________333333333333333333_______________________________
125 _________________________________________________________________33333333333333333333333333333333333333_________333333333333333333______________________________
126 __________________________________________________________________333333333333333333333333333333333333__________33333333333333333333____________________________
127 ___________________________________________________________________33333333333333333333333333333333333__________333333333333333333333___________________________
128 _____________________________________________________________________3333333333333333333333333333333333_________3333333333333333333333__________________________
129 ______________________________________________________________________3333333333333333333333333333__333________333333__33333333333333333________________________
130 _______________________________________________________________________33333333333333333333333333____333___3333333333___3333333333333333________________________
131 _________________________________________________________________________333333333333333333333333_____33333333333333_____3333333333333333_______________________
132 __________________________________________________________________________3333333333333333333333______33333333333333_____3333333333333333_______________________
133 ____________________________________________________________________________33333333333333333333_______3333333333333______3333333333333333______________________
134 ______________________________________________________________________________33333333333333333________3333333333333______3333333333333333______________________
135 _______________________________________________________________________________333333333333333__________33333333333_______3333333333333333______________________
136 ________________________________________________________________________________333333333333333_________33333333333_______3333333333333333______________________
137 _________________________________________________________________________________33333333333333________3333333333333______33333333333333333_____________________
138 __________________________________________________________________________________333333333333333_____333333333333333____333333333333333333_____________________
139 ___________________________________________________________________________________333333333333333____3333333333333333___333333333333333333_____________________
140 ____________________________________________________________________________________3333333333333333_33333333333333333333333333333333333333_____________________
141 _____________________________________________________________________________________333333333333333333333333333333333333333333333333333333_____________________
142 ______________________________________________________________________________________33333333333333333333333333333333333333333333333333333_____________________
143 ______________________________________________________________________________________333333333333333333333333333333333333333333333333333333____________________
144 _______________________________________________________________________________________33333333333333333333333333333333333333333333333333333____________________
145 _______________________________________________________________________________________33333333333333333333333333333333333333333333333333333____________________
146 ________________________________________________________________________________________3333333333333333333333333333333333333333333333333333____________________
147 ________________________________________________________________________________________3333333333333333333333333333333333333333333333333333____________________
148 ________________________________________________________________________________________3333333333333333333333333333333333333333333333333333____________________
149 ________________________________________________________________________________________333333333333333333333333333333333333333333333333333_____________________
150 ________________________________________________________________________________________333333333333333333333333333333333333333333333333333_____________________
151 ________________________________________________________________________________________333333333333333333333333333333333333333333333333333_____________________
152 ________________________________________________________________________________________333333333333333333333333333333333333333333333333333___1111111111________
153 ________________________________________________________________________________________3333333333333333333333333333333333333333333333333311111___1___1_1111111_
154 ________________________________________________________________________________________333333333333333333333333333333333333333333333333331___1___1___1___1_____
155 ________________________________________________________________________________________333333333333333333333333333333333333333333333333331___1___1___1___1_____
156 ________________________________________________________________________________________33333333333333333333333333333333333333333333333333111111111___111111111_
157 ________________________________________________________________________________________33333333333333333333333333333333333333333333333333_____1111111111_______
158 ________________________________________________________________________________________3333333333333333333333333333333333333333333333333_______________________
159 ________________________________________________________________________________________3333333333333333333333333333333333333333333333333_______________________
160 ________________________________________________________________________________________333333333333333333333333333333333333333333333333________________________
161 ________________________________________________________________________________________333333333333333333333333333333333333333333333333________________________
162 _______________________________________________________________________________________333333333333333333333333333333333333333333333333_________________________
163 _______________________________________________________________________________________333333333333333333333333333333333333333333333333_________________________
164 ______________________________________________________________________________________333333333333333333333333333333333333333333333333__________________________
165 ______________________________________________________________________________________333333333333333333333333333333333333333333333333__________________________
166 _____________________________________________________________________________________3333333333333333333333333333333333333333333333333__________________________
167 ________________________________________________________________________________________________________________________________________________________________
