    0         10        20        30        40        50        60        70        80        90        100       110       120       130       140       150       
    0123456789012345678901234567890123456789012345678901234567890123456789012345678901234567890123456789012345678901234567890123456789012345678901234567890123456789
0   ________________________________________________________________________________________________________________________________________________________________
1   ________________________________________________________________________________________________________________________________________________________________
2   ________________________________________________________________________________________________________________________________________________________________
3   ________________________________________________________________________________________________________________________________________________________________
4   ________________________________________________________________________________________________________________________________________________________________
5   ________________________________________________________________________________________________________________________________________________________________
6   ________________________________________________________________________________________________________________________________________________________________
7   ________________________________________________________________________________________________________________________________________________________________
8   ________________________________________________________________________________________________________________________________________________________________
9   ________________________________________________________________________________________________________________________________________________________________
10  ________________________________________________________________________________________________________________________________________________________________
11  ________________________________________________________________________________________________________________________________________________________________
12  ________________________________________________________________________________________________________________________________________________________________
13  ________________________________________________________________________________________________________________________________________________________________
14  ________________________________________________________________________________________________________________________________________________________________
15  ________________________________________________________________________________________________________________________________________________________________
16  ________________________________________________________________________________________________________________________________________________________________
17  ________________________________________________________________________________________________________________________________________________________________
18  ________________________________________________________________________________________________________________________________________________________________
19  ________________________________________________________________________________________________________________________________________________________________
20  ________________________________________________________________________________________________________________________________________________________________
21  ________________________________________________________________________________________________________________________________________________________________
22  ________________________________________________________________________________________________________________________________________________________________
23  ________________________________________________________________________________________________________________________________________________________________
24  ________________________________________________________________________________________________________________________________________________________________
25  ________________________________________________________________________________________________________________________________________________________________
26  ________________________________________________________________________________________________________________________________________________________________
27  ________________________________________________________________________________________________________________________________________________________________
28  ________________________________________________________________________________________________________________________________________________________________
29  ________________________________________________________________________________________________________________________________________________________________
30  ________________________________________________________________________________________________________________________________________________________________
31  ____________________________________________________________________________________________________________33___333____________________________________________
32  ____________________________________________________________________________________________________________33___333333_________________________________________
33  ___________________________________________________________________________________________________________3333333333333________________________________________
34  ___________________________________________________________________________________________________________33333333333333_______________________________________
35  __________________________________________________________________________________________________________3333333333333333______________________________________
36  __________________________________________________________________________________________________________33333333333333333_____________________________________
37  _________________________________________________________________________________________________________3333333333333333333____________________________________
38  _________________________________________________________________________________________________________33333333333333333333___________________________________
39  ________________________________________________________________________________________________________3333333333333333333333__________________________________
40  ________________________________________________________________________________________________________33333333333333333333333_________________________________
41  _______________________________________________________________________________________________________333333333333333333333333_________________________________
42  _______________________________________________________________________________________________________33333333333333333333333333_______________________________
43  ________________________________________________________________________________________________________333333333333333333333333333_____________________________
44  ________________________________________________________________________________________________________33333333333333333333333333333___________________________
45  ________________________________________________________________________________________________________33333333333333333333333333333___________________________
46  ________________________________________________________________________________________________________33333333333333333333333333333___11111111111111111111111_
47  _________________________________________________________________________________________________________3333333333333333333333333333___1______1___1___1___1____
48  _________________________________________________________________________________________________________33333333333333333333333333333___11____1___1___1___1____
49  _________________________________________________________________________________________________________33333333333333333333333333333_____1___1___1___11111111_
50  _________________________________________________________________________________________________________33333333333333333333333333333______11111111111111______
51  _________________________________________________________________________________________________________33333333333333333333333333333__________________________
52  _________________________________________________________________________________________________________33333333333333333333333333333__________________________
53  _________________________________________________________________________________________________________333333333333333333333333333333__________________3333___
54  __________________________________________________________________________________________________________33333333333333333333333333333______________3333333333_
55  __________________________________________________________________________________________________________3333333333333333_3333333333333___________333333333333_
56  _________________________________________________________________________________________________________33333333333333333_3333333333333__________3333333333333_
57  ___________________________________________________________________________________________________33333333333333333333333_333333333333333_______33333333333333_
58  ____________________________________________________________________________________________________3333333333333333333333_333333333333333333___333333333333333_
59  _________________________________________________________________________________________1111111_1111111133333333333333333_333333333333333333333333333333333333_
60  _________________________________________________________________________________________1___________333133333333333333333__33333333333333333333333333333333333_
61  _________________________________________________________________________________________1___________333133333333333333333__33333333333333333333333333333333333_
62  _________________________________________________________________________________________111111111_11111133333333333333333__33333333333333333333333333333333333_
63  _______________________________________________________________________________________________________333333333333333333___33333333333333333333333333333333333_
64  _______________________________________________________________________________________________________333333333333333333____3333333333333333333333333333333333_
65  ________________________________________________________________________________________________________33333333333333333____3333333333333333333333333333333333_
66  ________________________________________________________________________________________________________3333333333333333_____3333333333333333333333333333333333_
67  _________________________________________________________________________________________________________333333333333333______333333333333333333333333333333333_
68  _1111111111111_____________________________1111111111111_________________________________________________33333333333333_______333333333333333333333333333333333_
69  ____1___1___1_111______________________1111_____________11________________________________________________3333333333333_______333333333333333333333333333333333_
70  ____1___1___1___111________________1111___________________1________________________________________________33333333333_________33333333333333333333333333333333_
71  ____1___1___1___1__1___________1111________________________11______________________________________________333333333333________33333333333333333333333333333333_
72  ____11111___11111_111________11______________________________1______________________________________________33333333333________33333333333333333333333333333333_
73  _11111111111111111____________1_____________________________1_______________________________________________33333333333_________3333333333333333333333333333333_
74  _______________________________1__________________________111________________________________________________333333333__________3333333333333333333333333333333_
75  _______________________________1_____________________11111____________________________________________________33333333___________333333333333333333333333333333_
76  ________________________________1______________111111_________________________________________________________3333333333_________333333333333333333333333333333_
77  ________________________________111111111111111________________________________________________________________333333333__________33333333333333333333333333333_
78  _______________________________________________________________________________________________________________33333333____________3333333333333333333333333333_
79  ________________________________________________________________________________________________________________3333333____________3333333333333333333333333333_
80  _________________________________________________________________________________________________________________333333_____________333333333333333333333333333_
81  ___________________________________________________________________________________________________________________333_______________33333333333333333333333333_
82  ______________________________________________________________________________________________________________________________333333333333333333333333333333333_
83  _____________________________________________________________________________________________________________________________3333333333333333333333333333333333_
84  _____________________________________________________________________________________________________________________________3333333333333333333333333333333333_
85  _______________________________________________________________________________________________________________________________33333333333333333333333333333333_
86  __________________________________________________________________________________________________________________________________33333333333333333333333333333_
87  ___________________________________________________________________________________________________________________________________3333333333333333333333333333_
88  ____________________________________________________________________________________________________________________________________3333333333333333____3333333_
89  ______________________________________________________________________________________________________________________________________33333333______________333_
90  ________________________________________________________________________________________________________________________________________________________________
91  ________________________________________________________________________________________________________________________________________________________________
92  _______________________________________________________________________11111111111111111111_____________________________________________________________________
93  ___________________________________________________________________1111____________________11111________________________________________________________________
94  ________________________________________________________________111_____________________________1111____________________________________________________________
95  _______________________________________________________________1___________________________________1111_________________________________________________________
96  ________________________________________________________________11___________________________111111_____________________________________________________________
97  __________________________________________________________________111111111111111111111111111___________________________________________________________________
98  ________________________________________________________________________________________________________________________________________________________________
99  ________________________________________________________________________________________________________________________________________________________________
100 ________________________________________________________________________________________________________________________________________________________________
101 ________________________________________________________________________________________________________________________________________________________________
102 ________________________________________________________________________________________________________________________________________________________________
103 ________________________________________________________________________________________________________________________________________________________________
104 ________________________________________________________________________________________________________________________________________________________________
105 _______________________________________________________________________________1111_____________________________________________________________________________
106 ___________________________________________________________________________1111___111_________________________1111111111111111111111____________________________
107 ___________________________________________________________________________1__1___1__11______________________1_____________________1____________________________
108 _______________________________________111111111111111111111111111111______1__1___1___1_____________________1111111111111111111111__1___________________________
109 _______________________________________1_______1___1___1___1___1___11_______1111111___1____________________1______________________1_1___________________________
110 ______________________________________1________1___1___1___1___1___11_____________11_1____________________1________________________1_1__________________________
111 ______________________________________1________1___1___1___1___1___11_______________11____________________1_________________________11__________________________
112 ______________________________________1________1___1___1___1___1___11______________________________________1_________________________1__________________________
113 ______________________________________1________1___1___1___1___1____1______________________________________1_________________________1__________________________
114 _____________________________________1_________1___1___1___1___1___11______________________________________1__________________________1_________________________
115 _____________________________________1_________1_______1___1___1_11________________________________________1__________________________1_________________________
116 _____________________________________1_________1___1___1___1__111___________________________________________1__________________________1________________________
117 _____________________________________1_________1___1___1___111______________________________________________1______________1111111111__1________________________
118 ____________________________________1__________1___1___1_111_________________________________________________1_______11111111111111111111_______________________
119 ____________________________________1__________1___1___11_____________________________________________________1_____1___________________________________________
120 __________________________________11___________1___1_11_______________1111111111______________________________1_____1___________________________________________
121 ________________________________11_____________1___11________________1_________1_______________________________1____1___________________________________________
122 _______________________________1_______________1_11__________________1_________1________________________________1___1___________________________________________
123 _____________________________11________________11___________________11__________1________________________________1_1____________________________________________
124 ____________________________1__________________1______________________11________1_________________________________11____________________________________________
125 __________________________11___________________11_______________________11______1__________________________________1____________________________________________
126 ________________________11_____________________11_________________________11__11________________________________________________________________________________
127 _______________________1_______________________1_11_________________________11__________________________________________________________________________________
128 _______________________1_______________________1___11___________________________________________________________________________________________________________
129 _______________________1_______________________1_____1__________________________________________________________________________________________________________
130 _______________________1_______________________1_____1__________________________________________________________________________________________________________
131 _______________________111_____________________1____11__________________________________________________________________________________________________________
132 __________________________1____________________1_111____________________________________________________________________________________________________________
133 ___________________________11________________1111_______________________________________________________________________________________________________________
134 _____________________________1____________111___________________________________________________________________________________________________________________
135 ______________________________111111111111______________________________________________________________________________________________________________________
136 ________________________________________________________________________________________________________________________________________________________________
137 ________________________________________________________________________________________________________________________________________________________________
138 ________________________________________________________________________________________________________________________________________________________________
139 ________________________________________________________________________________________________________________________________________________________________
140 ________________________________________________________________________________________________________________________________________________________________
141 ________________________________________________________________________________________________________________________________________________________________
142 ________________________________________________________________________________________________________________________________________________________________
143 ________________________________________________________________________________________________________________________________________________________________
144 ________________________________________________________________________________________________________________________________________________________________
145 ________________________________________________________________________________________________________________________________________________________________
146 ________________________________________________________________________________________________________________________________________________________________
147 ________________________________________________________________________________________________________________________________________________________________
148 ________________________________________________________________________________________________________________________________________________________________
149 ________________________________________________________________________________________________________________________________________________________________
150 ________________________________________________________________________________________________________________________________________________________________
151 ________________________________________________________________________________________________________________________________________________________________
152 ________________________________________________________________________________________________________________________________________________________________
153 ________________________________________________________________________________________________________________________________________________________________
154 ________________________________________________________________________________________________________________________________________________________________
155 ________________________________________________________________________________________________________________________________________________________________
156 ________________________________________________________________________________________________________________________________________________________________
157 ________________________________________________________________________________________________________________________________________________________________
158 ________________________________________________________________________________________________________________________________________________________________
159 ________________________________________________________________________________________________________________________________________________________________
160 ________________________________________________________________________________________________________________________________________________________________
161 ________________________________________________________________________________________________________________________________________________________________
162 ________________________________________________________________________________________________________________________________________________________________
163 ________________________________________________________________________________________________________________________________________________________________
164 ________________________________________________________________________________________________________________________________________________________________
165 ________________________________________________________________________________________________________________________________________________________________
166 ________________________________________________________________________________________________________________________________________________________________
167 ________________________________________________________________________________________________________________________________________________________________
