    0         10        20        30        40        50        60        70        80        90        100       110       120       130       140       150       
    0123456789012345678901234567890123456789012345678901234567890123456789012345678901234567890123456789012345678901234567890123456789012345678901234567890123456789
0   ________________________________________________________________________________________________________________________________________________________________
1   ________________________________________________________________________________________________________________________________________________________________
2   ________________________________________________________________________________________________________________________________________________________________
3   ________________________________________________________________________________________________________________________________________________________________
4   ________________________________________________________________________________________________________________________________________________________________
5   ________________________________________________________________________________________________________________________________________________________________
6   ________________________________________________________________________________________________________________________________________________________________
7   ________________________________________________________________________________________________________________________________________________________________
8   ________________________________________________________________________________________________________________________________________________________________
9   ________________________________________________________________________________________________________________________________________________________________
10  ________________________________________________________________________________________________________________________________________________________________
11  ________________________________________________________________________________________________________________________________________________________________
12  ________________________________________________________________________________________________________________________________________________________________
13  ________________________________________________________________________________________________________________________________________________________________
14  ________________________________________________________________________________________________________________________________________________________________
15  ________________________________________________________________________________________________________________________________________________________________
16  ________________________________________________________________________________________________________________________________________________________________
17  ________________________________________________________________________________________________________________________________________________________________
18  ________________________________________________________________________________________________________________________________________________________________
19  ________________________________________________________________________________________________________________________________________________________________
20  ________________________________________________________________________________________________________________________________________________________________
21  ________________________________________________________________________________________________________________________________________________________________
22  ________________________________________________________________________________________________________________________________________________________________
23  ________________________________________________________________________________________________________________________________________________________________
24  ________________________________________________________________________________________________________________________________________________________________
25  ________________________________________________________________________________________________________________________________________________________________
26  ________________________________________________________________________________________________________________________________________________________________
27  ________________________________________________________________________________________________________________________________________________________________
28  ________________________________________________________________________________________________________________________________________________________________
29  ________________________________________________________________________________________________________________________________________________________________
30  ________________________________________________________________________________________________________________________________________________________________
31  ________________________________________________________________________________________________________________________________________________________________
32  ________________________________________________________________________________________________________________________________________________________________
33  ________________________________________________________________________________________________________________________________________________________________
34  ________________________________________________________________________________________________________________________________________________________________
35  ________________________________________________________________________________________________________________________________________________________________
36  ________________________________________________________________________________________________________________________________________________________________
37  ________________________________________________________________________________________________________________________________________________________________
38  ________________________________________________________________________________________________________________________________________________________________
39  ________________________________________________________________________________________________________________________________________________________________
40  ________________________________________________________________________________________________________________________________________________________________
41  ________________________________________________________________________________________________________________________________________________________________
42  _____________________________________33333333333333333333333333333333333333333333333333333333333333_____________________________________________________________
43  __________________________________33333333333333333333333333333333333333333333333333333333333333333_____________________________________________________________
44  ________________________________33333333333333333333333333333333333333333333333333333333333333333333____________________________________________________________
45  ______________________________3333333333333333333333333333333333333333333333333333333333333333333333____________________________________________________________
46  ____________________________33333333333333333333333333333333333333333333333333333333333333333333333_____________________________________________________________
47  ___________________________333333333333333333333333333333333333333333333333333333333333333333333333_____________________________________________________________
48  __________________________33333333333333333333333333333333333333333333333333333333333333333333333_______________________________________________________________
49  _________________________33333333333333333333333333333333333333333333333333333333333333333333333________________________________________________________________
50  ________________________3333333333333333333333333333333333333333333333333333333333333333333333__________________________________________________________________
51  _______________________3333333333333333333333333333333333333333333333333333333333333333333333___________________________________________________________________
52  ______________________3333333333333333333333333333333333333333333333333333333333333333333333____________________________________________________________________
53  _____________________3333333333333333333333333333333333333333333333333333333333333333333333_____________________________________________________________________
54  _____________________333333333333333333333333333333333333333333333333333333333333333333333______________________________________________________________________
55  ____________________3333333333333333333333333333333333333333333333333333333333333333333333______________________________________________________________________
56  ____________________333333333333333333333333333333333333333333333333333333333333333333333_______________________________________________________________________
57  ___________________333333333333333333333333333333333333333333333333333333333333333333333________________________________________________________________________
58  ___________________3333333333333333333333333333333333333333333333333333333333333333333333_______________________________________________________________________
59  ___________________3333333333333333333333333333333333333333333333333333333333333333333333_______________________________________________________________________
60  __________________333333333333333333333333333333333333333333333333333333333333333333333333______________________________________________________________________
61  __________________333333333333333333333333333333333333333333333333333333333333333333333333______________________________________________________________________
62  _________________33333333333333333333333333333333333333333333333333333333333333333333333333_____________________________________________________________________
63  _________________333333333333333333333333333333333333333333333333333333333333333333333333333____________________________________________________________________
64  _________________33333333333333333333333333333333333333333333333333333333333333333333333333333__________________________________________________________________
65  _________________333333333333333333333333333333333333333333333333333333333333333333333333333333_________________________________________________________________
66  ________________33333333333333333333333333333333333333333333333333333333333333333333333333333333________________________________________________________________
67  ________________3333333333333333333333333333333333333333333333333333333333333333333333333333333333______________________________________________________________
68  ________________333333333333333333333333333333333333333333333333333333333333333333333333333333333333____________________________________________________________
69  _______________3333333333333333333333333333333333333333333333333333333333333333333333333333333333333333_________________________________________________________
70  _______________3333333333333333333333333333333333333333333333333333333333333333333333333333333333333333333______________________________________________________
71  _______________3333333333333333333333333333333333333333333333333333333333333333333333333333333333333333333333___________________________________________________
72  _______________33333333333333333333333333333333333333333333333333333333333333333333333333333333333333333333333333_______________________________________________
73  _______________333333333333333333333333333333333333333333333333333333333333333333333333333333333333333333333333333333___________________________________________
74  ______________3333333333333333333333333333333333333333333333333333333333333333333333333333333333333333333333333333333333________________________________________
75  ______________3333333333333333333333333333333333333333333333333333333333333333333333333333333333333333333333333333333333333_____________________________________
76  ______________333333333333333333333333333333333333333333333333333333333333333333333333333333333333333333333333333333333333333___________________________________
77  ______________333333333333333333333333333333333333333333333333333333333333333333333333333333333333_3333333333333333333333333333_________________________________
78  ______________333333333333333333333333333333333333333333333333333333333333333333333333333333333333_33333333333333333333333333333________________________________
79  ______________333333333333333333333333333333333333333333333333333333333333333333333333333333333333_3333333333333333333333333333333______________________________
80  ______________333333333333333333333333333333333333333333333333333333333333333333333333333333333333_333333333333333333333333333333333____________________________
81  ______________333333333333333333333333333333333333333333333333333333333333333333333333333333333333_3333333333333333333333333333333333___________________________
82  ______________33333333333333333333333333333333333333333333333333333333333333333333333333333333333___33333333333333333333333333333333333_________________________
83  ______________333333333333333333333333333333333333333333333333333333333333333333333_3333333333333___333333333333333333333333333333333333________________________
84  ______________333333333333333333333333333333333333333333333333333333333333333333333_3333333333333___333333333333333333333333333333333333________________________
85  ______________3333333333333333333333333333333333333333333333333333333333333333333333_333333333333____333333333333333333333333333333333333_______________________
86  ______________3333333333333333333333333333333333333333333333333333333333333333333333_333333333333____333333333333333333333333333333333333_______________________
87  ______________33333333333333333333333333333333333333333333333333333333333333333333333___333333333____3333333333333333333333333333333333333______________________
88  ______________33333333333333333333333333333333333333333333333333333333333333333333333___333333333____3333333333333333333333333333333333333______________________
89  ______________33333333333333333333333333333333333333333333333333333333333333333333333____33333333____33333333333333333333333333333333333333_____________________
90  ______________33333333333333333333333333333333333333333333333333333333333333333333333____33333333____333333333333333333333333333333333333333____________________
91  ______________333333333333333333333333333333333333333333333333333333333333333333333333____3333333____333333333333333333333333333333333333333____________________
92  ______________333333333333333333333333333333333333333333333333333333333333333333333333____3333333____3333333333333333333333333333333333333333___________________
93  ______________333333333333333333333333333333333333333333333333333333333333333333333333_____333333____3333333333333333333333333333333333333333___________________
94  ______________3333333333333333333333333333333333333333333333333333333333333333333333333____333333____33333333333333333333333333333333333333333__________________
95  ______________3333333333333333333333333333333333333333333333333333333333333333333333333_____33333____33333333333333333333333333333333333333333__________________
96  ______________3333333333333333333333333333333333333333333333333333333333333333333333333_____33333____33333333333333333333333333333333333333333__________________
97  ______________33333333333333333333333333333333333333333333333333333333333333333333333333_____33333__33333333333333333333333333333333333333333___________________
98  ______________333333333333333333333333333333333333333333333333333333333333333333333333333____33333_33333333333333333333___3333333333333333333___________________
99  ______________3333333333333333333333333333333333333333333333333333333333333333333333333333__333333_333333333333333333_______33333333333333333___________________
100 _______________333333333333333333333333333333333333333333333333333333333333333333333333333__333333_33333333333333_333________3333333333333333___________________
101 _______________33333333333333333333333333333333333333333333333333333333333333333333333333333_33333_3333333333333______________33333333333333____________________
102 _______________33333333333333333333333333333333333333333333333333333333333333333333333333333_33333_333333333333_________________333333333333____________________
103 _______________333333333333333333333333333333333333333333333333333333333333333333333333333333_3333_33333333333____________________3333333333____________________
104 _______________333333333333333333333333333333333333333333333333333333333333333333333333333333_3333_3333333333______________________33333333_____________________
105 _______________333333333333333333333333333333333333333333333333333333333333333333333333333333_3333_3333333333______________________3333333______________________
106 _______________3333333333333333333333333333333333333333333333333333333333333333333333333333333_333_3333333333_______________________33333_______________________
107 _______________3333333333333333333333333333333333333333333333333333333333333333333333333333333_333_333333333________________________3333________________________
108 _______________33333333333333333333333333333333333333333333333333333333333333333333333333333333_33_3333333_3________________________333_________________________
109 _______________33333333333333333333333333333333333333333333333333333333333333333333333333333333_33_3333333_________________________3333_________________________
110 _______________333333333333333333333333333333333333333333333333333333333333333333333333333333_3_33_333333__________________________333__________________________
111 _______________333333333333333333333333333333333333333333333333333333333333333333333333333333_3_33_333_33_______________________________________________________
112 _______________3333333333333333333333333333333333333333333333333333333333333333333333333333_33__33_333_3________________________________________________________
113 ________________333333333333333333333333333333333333333333333333333333333333333333333333333_33__33_33_33________________________________________________________
114 ________________3333333333333333333333333333333333333333333333333333333333333333333333333333_3_3_3_33_33________________________________________________________
115 ________________3333333333333333333333333333333333333333333333333333333333333333333333333333_33__3_33_33________________________________________________________
116 ________________3333333333333333333333333333333333333333333333333333333333333333333333333333_33__3_3_333________________________________________________________
117 ________________33333333333333333333333333333333333333333333333333333333333333333333333333_33_3__3_3_33_________________________________________________________
118 ________________333333333333333333333333333333333333333333333333333333333333333333333333333_3_3__3_3_33_________________________________________________________
119 ________________3333333333333333333333333333333333333333333333333333333333333333333333333333__33_3_3_3__________________________________________________________
120 ________________33333333333333333333333333333333333333333333333333333333333333333333333333333__3_3_3_3111111111111111111111111111111111111______________________
121 _________________3333333333333333333333333333333333333333333333333333333333333333333333333333__3_3_3_31___________________________________1_____________________
122 _________________33333333333333333333333333333333333333333333333333333333333333333333333333_33______331___________________________________1_____________________
123 _________________33333333333333333333333333333333333333333333333333333333333333333333333333_333_3___3331__________________________________1_____________________
124 _________________333333333333333333333333333333333333333333333333333333333333333333333333_33_33_____3331__________________________________1_____________________
125 _________________3333333333333333333333333333333333333333333333333333333333333333333333333___333____3331111___________________________11111_____________________
126 _________________333333333333333333333333333333333333333333333333333333333333333333333333333__33____333133_11111111_________1111111111__________________________
127 _________________33333333333333333333333333333333333333333333333333333333333333333333333333333333___33133__________111111111____________________________________
128 _________________33333333333333333333333333333333333333333333333333333333333333333333333333333333___31333_______________________________________________________
129 __________________3333333333333333333333333333333333333333333333333333333333333333333333333333333___3133________________________________________________________
130 __________________3333333333333333333333333333333333333333333333333333333333333333333333333333333__3133_________________________________________________________
131 __________________3333333333333333333333333333333333333333333333333333333333333333333333333311111111113_________________________________________________________
132 __________________333333333333333333333333333333333333333333333333333333333333333333333333333333333333__________________________________________________________
133 __________________33333333333333333333333333333333333333333333333333333333333333333333333333333333333___________________________________________________________
134 __________________33333333333333333333333333333333333333333333333333333333333333333333333333333333333___________________________________________________________
135 ___________________333333333333333333333333333333333333333333333333333333333333333333333333333333333____________________________________________________________
136 ___________________333333333333333333333333333333333333333333333333333333333333333333333333333333333____________________________________________________________
137 ___________________33333333333333333333333333333333333333333333333333333333333333333333333333333333_____________________________________________________________
138 ___________________33333333333333333333333333333333333333333333333333333333333333333333333333333333____________________________________________1111111111111111_
139 ____________________333333333333333333333333333333333333333333333333333333333333333333333333333333______________________________________11111111___11111___1____
140 ____________________333333333333333333333333333333333333333333333333333333333333333333333333333333__________________________________1111_______1___1___1___1____
141 _____________________3333333333333333333333333333333333333333333333333333333333333333333333333333___________________________________1__________1___1___1___1____
142 _____________________3333333333333333333333333333333333333333333333333333333333333333333333333333___________________________________1__________1___1___1___1____
143 ______________________333333333333333333333333333333333333333333333333333333333333333333333333333___________________________________111111111111111111111111111_
144 _______________________3333333333333333333333333333333333333333333333333333333333333333333333333________________________________________________________________
145 _______________________3333333333333333333333333333333333333333333333333333333333333333333333333________________________________________________________________
146 ________________________33333333333333333333333333333333333333333333333333333333333333333333333_________________________________________________________________
147 ________________________33333333333333333333333333333333333333333333333333333333333333333333333_________________________________________________________________
148 _________________________333333333333333333333333333333333333333333333333333333333333333333333__________________________________________________________________
149 __________________________33333333333333333333333333333333333333333333333333333333333333333333__________________________________________________________________
150 ___________________________333333333333333333333333333333333333333333333333333333333333333333___________________________________________________________________
151 ____________________________33333333333333333333333333333333333333333333333333333333333333333___________________________________________________________________
152 ____________________________333333333333333333333333333333333333333333333333333333333333333_____________________________________________________________________
153 _____________________________3333333333333333333333333333333333333333333333333333333333333______________________________________________________________________
154 ______________________________3333333333333333333333333333333333333333333333333333333333________________________________________________________________________
155 ________________________________333333333333333333333333333333333333333333333333333333__________________________________________________________________________
156 __________________________________333333333333333333333333333333333333333333333333333___________________________________________________________________________
157 _____________________________________3333333333333333333333333333333333333333333333_____________________________________________________________________________
158 _______________________________________333333333333333333333333333333333333333__________________________________________________________________________________
159 ____________________________________________________3333333333333333____________________________________________________________________________________________
160 ________________________________________________________________________________________________________________________________________________________________
161 ________________________________________________________________________________________________________________________________________________________________
162 ________________________________________________________________________________________________________________________________________________________________
163 ________________________________________________________________________________________________________________________________________________________________
164 ________________________________________________________________________________________________________________________________________________________________
165 ________________________________________________________________________________________________________________________________________________________________
166 ________________________________________________________________________________________________________________________________________________________________
167 ________________________________________________________________________________________________________________________________________________________________
