    0         10        20        30        40        50        60        70        80        90        100       110       120       130       140       150       
    0123456789012345678901234567890123456789012345678901234567890123456789012345678901234567890123456789012345678901234567890123456789012345678901234567890123456789
0   ________________________________________________________________________________________________________________________________________________________________
1   ________________________________________________________________________________________________________________________________________________________________
2   ________________________________________________________________________________________________________________________________________________________________
3   ________________________________________________________________________________________________________________________________________________________________
4   ________________________________________________________________________________________________________________________________________________________________
5   ________________________________________________________________________________________________________________________________________________________________
6   ________________________________________________________________________________________________________________________________________________________________
7   ________________________________________________________________________________________________________________________________________________________________
8   ________________________________________________________________________________________________________________________________________________________________
9   ________________________________________________________________________________________________________________________________________________________________
10  ________________________________________________________________________________________________________________________________________________________________
11  ________________________________________________________________________________________________________________________________________________________________
12  ________________________________________________________________________________________________________________________________________________________________
13  ________________________________________________________________________________________________________________________________________________________________
14  ________________________________________________________________________________________________________________________________________________________________
15  ________________________________________________________________________________________________________________________________________________________________
16  ________________________________________________________________________________________________________________________________________________________________
17  ________________________________________________________________________________________________________________________________________________________________
18  ________________________________________________________________________________________________________________________________________________________________
19  ________________________________________________________________________________________________________________________________________________________________
20  ________________________________________________________________________________________________________________________________________________________________
21  ________________________________________________________________________________________________________________________________________________________________
22  ________________________________________________________________________________________________________________________________________________________________
23  ________________________________________________________________________________________________________________________________________________________________
24  ________________________________________________________________________________________________________________________________________________________________
25  ________________________________________________________________________________________________________________________________________________________________
26  ________________________________________________________________________________________________________________________________________________________________
27  ________________________________________________________________________________________________________________________________________________________________
28  ________________________________________________________________________________________________________________________________________________________________
29  ________________________________________________________________________________________________________________________________________________________________
30  ________________________________________________________________________________________________________________________________________________________________
31  ________________________________________________________________________________________________________________________________________________________________
32  ________________________________________________________________________________________________________________________________________________________________
33  ________________________________________________________________________________________________________________________________________________________________
34  ________________________________________________________________________________________________________________________________________________________________
35  ________________________________________________________________________________________________________________________________________________________________
36  ________________________________________________________________________________________________________________________________________________________________
37  ________________________________________________________________________________________________________________________________________________________________
38  ________________________________________________________________________________________________________________________________________________________________
39  ________________________________________________________________________________________________________________________________________________________________
40  ________________________________________________________________________________________________________________________________________________________________
41  ________________________________________________________________________________________________________________________________________________________________
42  ________________________________________________________________________________________________________________________________________________________________
43  ________________________________________________________________________________________________________________________________________________________________
44  ________________________________________________________________________________________________________________________________________________________________
45  ________________________________________________________________________________________________________________________________________________________________
46  ________________________________________________________________________________________________________________________________________________________________
47  ________________________________________________________________________________________________________________________________________________________________
48  ________________________________________________________________________________________________________________________________________________________________
49  ________________________________________________________________________________________________________________________________________________________________
50  ________________________________________________________________________________________________________________________________________________________________
51  ________________________________________________________________________________________________________________________________________________________________
52  ________________________________________________________________________________________________________________________________________________________________
53  ________________________________________________________________________________________________________________________________________________________________
54  ________________________________________________________________________________________________________________________________________________________________
55  ________________________________________________________________________________________________________________________________________________________________
56  ________________________________________________________________________________________________________________________________________________________________
57  ________________________________________________________________________________________________________________________________________________________________
58  ________________________________________________________________________________________________________________________________________________________________
59  ________________________________________________________________________________________________________________________________________________________________
60  ____________________________________________________________111111111_____________________________________11111111111111111111111111111111111___________________
61  ____________________________________________________________1_______1_____________________________________1___1___11111___1111___11111___1__1___________________
62  ____________________________________________________________1_______1_____________________________________1___1___1___1___1__1___1___1___1__1___________________
63  ____________________________________________________________11____11______________________________________1___1___1___1___1__1___1___1___1__1___________________
64  ______________________________________________________________1111_________________________________________1__1___1___1___1__1___1___1___1__1___________________
65  ____________________________________________________________________________________________________________1_11111_1111111__1___1___1___1__1___________________
66  _____________________________________________________________________________________________________________1111111_____1___1___1___1___1__1___________________
67  _________________________________________________________________________________________________________________________1___1___1___11111__1___________________
68  ________________________________________________________________________________________________________________________1111111111___1111__1____________________
69  ______________________________________________________________________________________________________________________________1111111____111____________________
70  ________________________________________________________________________________________________________________________________________________________________
71  ________________________________________________________________________________________________________________________________________________________________
72  _11111111111111111111111111111111111111111111111111111111111111111111111111111111111____________________________________________________________________________
73  ____1___1___1___1___1_________________________________________111111_______________1____________________________________________________________________________
74  ____1___1___1___1___1______________________1111111111111111111______111111111______1____________________________________________________________________________
75  ____1___1___1___1___1________________111111__________________________________1111__1____________________________________________________________________________
76  ____1___1___1___1___1__________111111____________________________________________111____________________________________________________________________________
77  ____1___1___1___1___1_____11111____________________________________________________11___________________________________________________________________________
78  ____1___1___1___1___1_1111_________________________________________________________1_11_________________________________________________________________________
79  ____1___1___1___1_1111_____________________________________________________________1___1________________________________________________________________________
80  ____1___1___111111_________________________________________________________________1____1_______________________________________________________________________
81  ____1___1_1111_____________________________________________________________________1_____11_____________________________________________________________________
82  _111111111_________________________________________________________________________1_______1____________________________________________________________________
83  ___________________________________________________________________________________11111111111__________________________________________________________________
84  _____________________________________________________________________________________________1111111111_________________________________________________________
85  _______________________________________________________________________________________________1______1_________________________________________________________
86  ________________________________________________________________________________________________1_____1_________________________________________________________
87  _________________________________________________________________________________________________11___1_________________________________________________________
88  ___________________________________________________________________________________________________1__1_________________________________________________________
89  ____________________________________________________________________________________________________1_1_________________________________________________________
90  ____________________________________________________________________________________________________1_1_________________________________________________________
91  ____________________________________________________________________________________________________1_1_________________________________________________________
92  _______________________________________________________________1111111______________________________1_1_________________________________________________________
93  _____________________________________________________________11_______11____________________________1_1_________________________________________________________
94  ____________________________________________________________1___________11__________________________1_1_________________________________________________________
95  ___________________________________________________________1______________11________________________1_1_________________________________________________________
96  __________________________________________________________1_________________11______________________1_1_________________________________________________________
97  _________________________________________________________111________________1_______________________1_1_________________________________________________________
98  ____________________________________________________________11______________1_______________________1_1_________________________________________________________
99  ______________________________________________________________11___________1________________________1_1_________________________________________________________
100 ________________________________________________________________11________1_________________________1_1_________________________________________________________
101 __________________________________________________________________11_____1__________________________1_1_________________________________________________________
102 ____________________________________________________________________11111___________________________111_________________________________________________________
103 ____________________________________________________________________________________________________111_________________________________________________________
104 __________________________________1111111111111111__________________________________________________111_________________________________________________________
105 ________________________________11______________1___________________________________________________111_________________________________________________________
106 _______________________________1______________11____________________________________________________111_________________________________________________________
107 _______________________________1_____________1______________________________________________________111_________________________________________________________
108 ________________________________11_________11_______________________________________________________111_________________________________________________________
109 __________________________________111111111_________________________________________________________111_________________________________________________________
110 ____________________________________________________________________________________________________111_________________________________________________________
111 ____________________________________________________________________________________________________111_________________________________________________________
112 ____________________________________________________________________________________________________111_________________________________________________________
113 ____________________________________________________________________________________________________111_________________________________________________________
114 ____________________________________________________________________________________________________111_________________________________________________________
115 ____________________________________________________________________________________________________1___________________________________________________________
116 ____________________________________________________________________________________________________1___________________________________________________________
117 ___________________________________________________________________________________________________11___________________________________________________________
118 __________________________________________________________________________________________________1_1___________________________________________________________
119 _________________________________________________________________________________________________1__1___________________________________________________________
120 _________________________________________________________________________________________________1__1___________________________________________________________
121 ________________________________________________________________________________________________1___1___________________________________________________________
122 _______________________________________________________________________________________________1____1___________________________________________________________
123 __________________________________________________________________________________________1____1____1___________________________________________________________
124 _________________________________________________________________________________________11___1_____1___________________________________________________________
125 _________________________________________________________________________________________11__1______1___________________________________________________________
126 ________________________________________________________________________________________1_1__1______1___________________________________________________________
127 _______________________________________________________________________________________1__1_1_______1___________________________________________________________
128 _______________________________________________________________________________________1__11________1___________________________________________________________
129 ______________________________________________________________________________________1___1_________1___________________________________________________________
130 _____________________________________________________________________________________1____1_________1___________________________________________________________
131 _____________________________________________________________________________________1__1111111111111___________________________________________________________
132 ____________________________________________________________________________________1___11_1_________________11_________________________________________________
133 ___________________________________________________________________________________1____1__1____________________________________________________________________
134 ___________________________________________________________________________________1___11_1_____________________________________________________________________
135 __________________________________________________________________________________1___1111______________________________________________________________________
136 _________________________________________________________________________________1____1_1_______________________________________________________________________
137 ________________________________________________________________________________1____1__1_______________________________________________________________________
138 ________________________________________________________________________________1___1__11_______________________________________________________________________
139 _______________________________________________________________________________1____1_1_1_______________________________________________________________________
140 ______________________________________________________________________________1____1__1_1_______________________________________________________________________
141 ______________________________________________________________________________1___1__1__1_______________________________________________________________________
142 _____________________________________________________________________________1____1_1___1_______________________________________________________________________
143 ____________________________________________________________________________1___111111111_______________________________________________________________________
144 __________________________________________________________________________1111111__1____________________________________________________________________________
145 __________________________________________________________________________11___11_1_____________________________________________________________________________
146 __________________________________________________________________________1____1_1______________________________________________________________________________
147 __________________________________________________________________________1___1_1_______________________________________________________________________________
148 _________________________________________________________________________11__1__1_______________________________________________________________________________
149 __________________________________________________________________________1__1_1________________________________________________________________________________
150 ____________________________________________11111111111111111111111111____1_1_1_________________________________________________________________________________
151 ____________________________________________1__1__1__1__1___1__1__1__1____11__1_________________________________________________________________________________
152 ____________________________________________1__1__1__1__1___1__1__1__1111111_1__________________________________________________________________________________
153 ____________________________________________1__1__1__1__1___1__1__1__11___1_1___________________________________________________________________________________
154 ____________________________________________1__1__1__1__1___1__1__1__11__111____________________________________________________________________________________
155 11111111111111111___________________________1__1__1__1__1___1__1__1__11__111____________________________________________________________________________________
156 ________________111111111111111111111111111111111111111111111111111111111_1_____________________________________________________________________________________
157 ________________________________________________________________________________________________________________________________________________________________
158 ________________________________________________________________________________________________________________________________________________________________
159 ________________________________________________________________________________________________________________________________________________________________
160 ________________________________________________________________________________________________________________________________________________________________
161 ________________________________________________________________________________________________________________________________________________________________
162 ________________________________________________________________________________________________________________________________________________________________
163 ________________________________________________________________________________________________________________________________________________________________
164 ________________________________________________________________________________________________________________________________________________________________
165 ________________________________________________________________________________________________________________________________________________________________
166 ________________________________________________________________________________________________________________________________________________________________
167 ________________________________________________________________________________________________________________________________________________________________
