    0         10        20        30        40        50        60        70        80        90        100       110       120       130       140       150       
    0123456789012345678901234567890123456789012345678901234567890123456789012345678901234567890123456789012345678901234567890123456789012345678901234567890123456789
0   ________________________________________________________________________________________________________________________________________________________________
1   ________________________________________________________________________________________________________________________________________________________________
2   ________________________________________________________________________________________________________________________________________________________________
3   ________________________________________________________________________________________________________________________________________________________________
4   ________________________________________________________________________________________________________________________________________________________________
5   ________________________________________________________________________________________________________________________________________________________________
6   ________________________________________________________________________________________________________________________________________________________________
7   ________________________________________________________________________________________________________________________________________________________________
8   ________________________________________________________________________________________________________________________________________________________________
9   ________________________________________________________________________________________________________________________________________________________________
10  ________________________________________________________________________________________________________________________________________________________________
11  ________________________________________________________________________________________________________________________________________________________________
12  ________________________________________________________________________________________________________________________________________________________________
13  ________________________________________________________________________________________________________________________________________________________________
14  ________________________________________________________________________________________________________________________________________________________________
15  ________________________________________________________________________________________________________________________________________________________________
16  ________________________________________________________________________________________________________________________________________________________________
17  ________________________________________________________________________________________________________________________________________________________________
18  ________________________________________________________________________________________________________________________________________________________________
19  ________________________________________________________________________________________________________________________________________________________________
20  ________________________________________________________________________________________________________________________________________________________________
21  ________________________________________________________________________________________________________________________________________________________________
22  ________________________________________________________________________________________________________________________________________________________________
23  ________________________________________________________________________________________________________________________________________________________________
24  ________________________________________________________________33____3_________________________________________________________________________________________
25  ________________________________________________________________3333__33________________________________________________________________________________________
26  _______________________________________________________________33333__333_______________________________________________________________________________________
27  ______________________________________________________________3333333_333_______________________________________________________________________________________
28  _____________________________________________________________33333333_333_______________________________________________________________________________________
29  ___________________________________________________________333333333333333______________________________________________________________________________________
30  __________________________________________________________3333333333333333______________________________________________________________________________________
31  ________________________________________________________333333333333333333______________________________________________________________________________________
32  ______________________________________________________33333333333333333333______________________________________________________________________________________
33  ____________________________________________________333333333333333333333_______________________________________________________________________________________
34  __________________________________________________33333333333333333333333_______________________________________________________________________________________
35  __________________________________333333333333333333333333333333333333333_______________________________________________________________________________________
36  _________________333333333333333333333333333333333333333_____3333333333_________________________________________________________________________________________
37  ______________33333333333333333333______________________________3_333___________________________________________________________________________________________
38  _____________33333333333333333333_________________________________3_____________________________________________________________________________________________
39  ___________333333333333333333333________________________________________________________________________________________________________________________________
40  __________333333333333333333333_________________________________________________________________________________________________________________________________
41  ________3333333333333333333333__________________________________________________________________________________________________________________________________
42  ______33333333333333333333333___________________________________________________________________________________________________________________________________
43  ___3333333333333333333333333____________________________________________________________________________________________________________________________________
44  _333333333333333333333333333____________________________________________________________________________________________________________________________________
45  _33333333333333333333333333_____________________________________________________________________________________________________________________________________
46  _3333333333333333333333333______________________________________________________________________________________________________________________________________
47  _3333333333333333333333333______________________________________________________________________________________________________________________________________
48  _33333333333333333333_333_______________________________________________________________________________________________________________________________________
49  _33333333333333333333__3________________________________________________________________________________________________________________________________________
50  _33333333333333333333__3________________________________________________________________________________________________________________________________________
51  _3333333333333333_333___________________________________________________________________________________________________________________________________________
52  _3333333333333333__33___________________________________________________________________________________________________________________________________________
53  _33333333333333333______________________________________________________________________________________________________________________________________________
54  _33333333333333333______________________________________________________________________________________________________________________________________________
55  _333333333333333________________________________________________________________________________________________________________________________________________
56  _33333333333333_________________________________________________________________________________________________________________________________________________
57  _3333333333333333_______________________________________________________________________________________________________________________________________________
58  _33333333333333333______________________________________________________________________________________________________________________________________________
59  _333333333333333________________________________________________________________________________________________________________________________________________
60  _33333333333333________________________________________________________________________________11111111_________________________________________________________
61  _3333333333333_________________________________________________________________________________1_______1________________________________________________________
62  _3333333333___________________________________________________________________________________1_________1_______________________________________________________
63  _333333_______________________________________________________________________________________1_________1_______________________________________________________
64  _3333________________________________________________________________________________________1___________1______________________________________________________
65  _33__________________________________________________________________________________________1____________1_____________________________________________________
66  _3__________________________________________________________________________________________1____________1______________________________________________________
67  _____________________________________________________________________________________________1__________1_______________________________________________________
68  _____________________________________________________________________________________________1________11________________________________________________________
69  ______________________________________________________________________________________________11____11__________________________________________________________
70  ________________________________________________________________________________________________1111____________________________________________________________
71  ________________________________________________________________________________________________________________________________________________________________
72  ____________________________________________________________________________111111111111111111111____________________________111111_____________________________
73  ____________________________________________________________________________1___________________1____________________________1_____1____________________________
74  ____________________________________________________________________________1___________________1___________________________1______1____________________________
75  ____________________________________________________________________________1___________________1___________________________1_______1___________________________
76  ____________________________________________________________________________111111111111111111111__________________________1________1___________________________
77  ___________________________________________________________________________________________________________________________1______11____________________________
78  __________________________________________________________________________________________________________________________111___11______________________________
79  _____________________________________________________________________________________________________________________________111________________________________
80  ______________________________________________________________________________11111111111_______________________________________________________________________
81  ________________________________________________________1111111111111111111111___________11_____________________________________________________________________
82  ______________________________________111111111111111111___1___1___1___1___1_______________1____________________________________________________________________
83  111111111111111111111111111111111111111111111111___1___1___1___1___1___1___1__________1111111___________________________________________________________________
84  111111111111111111111111111111111111111111111111___1___1___1___1___1___1___1_________1__________________________________________________________________________
85  _111111111111___11111___11111111111111111111111____1___1___1___1___1___1___1_______11___________________________________________________________________________
86  ____1___1___1___1___1___1____111111111_________1___1___1___1___1___1___1___1______1_____________________________________________________________________________
87  ____1___1___1___1___1___1___1___________________11_1___1___1___1___1___1___1_____1______________________________________________________________________________
88  ____1___1___1___1___1___1__1______________________11___1___1___1___1___1___1___11_______________________________________________________________________________
89  ____1___1___1___1___1___1__1_______________________1___1___1___1___1___1___1_11_________________________________________________________________________________
90  ____1___1___1___1___1___1_1_________________________11_1___1___1___1___1___11___________________________________________________________________________________
91  ____1___1___1___1___1___11____________________________1111111111111111111111____________________________________________________________________________________
92  ____1___1___1___1___1__11_______________________________________________________________________________________________________________________________________
93  ____1___1___11111111111_________________________________________________________________________________________________________________________________________
94  _1111111111111111_______________________________________________________________________________________________________________________________________________
95  ________________________________________________________________________________________________________________________________________________________________
96  ________________________________________________________________________________________________________________________________________________________________
97  ________________________________________________________________________________________________________________________________________________________________
98  ________________________________________________________________________________________________________________________________________________________________
99  ________________________________________________________________________________________________________________________________________________________________
100 ________________________________________________________________________________________________________________________________________________________________
101 ________________________________________________________________________________________________________________________________________________________________
102 ________________________________________________________________________________________________________________________________________________________________
103 ________________________________________________________________________________________________________________________________________________________________
104 ________________________________________________________________________________________________________________________________________________________________
105 ________________________________________________________________________________________________________________________________________________________________
106 ________________________________________________________________________________________________________________________________________________________________
107 ________________________________________________________________________________________________________________________________________________________________
108 ________________________________________________________________________________________________________________________________________________________________
109 ________________________________________________________________________________________________________________________________________________________________
110 ________________________________________________________________________________________________________________________________________________________________
111 ________________________________________________________________________________________________________________________________________________________________
112 ________________________________________________________________________________________________________________________________________________________________
113 __________________________________________________________________111111________________________________________________________________________________________
114 ________________________________________________________________11______111_____________________________________________________________________________________
115 ______________________________________________________________11___________11___________________________________________________________________________________
116 ______________________________________________________________1_____________1___________________________________________________________________________________
117 ______________________________________________________________1_____________1___________________________________________________________________________________
118 ______________________________________________________________1_____________1___________________________________________________________________________________
119 ______________________________________________________________111111111111111___________________________________________________________________________________
120 ________________________________________________________________________________________________________________________________________________________________
121 ________________________________________________________________________________________________________________________________________________________________
122 ________________________________________________________________________________________________________________________________________________________________
123 ________________________________________________________________________________________________________________________________________________________________
124 ________________________________________________________________________________________________________________________________________________________________
125 ________________________________________________________________________________________________________________________________________________________________
126 ________________________________________________________________________________________________________________________________________________________________
127 ________________________________________________________________________________________________________________________________________________________________
128 ________________________________________________________________________________________________________________________________________________________________
129 ________________________________________________________________________________________________________________________________________________________________
130 ________________________________________________________________________________________________________________________________________________________________
131 ________________________________________________________________________________________________________________________________________________________________
132 _________________________________________________111111111111_____________________________________________________11111111_____________1111111__________________
133 ________________________________________________1____________1____________________________________________________11__1___1___________1___1__1__________________
134 ________________________________________________1_____________11__________________________________________________11__1____1__________1___1__1__________________
135 _______________________________________________1________________1________________________________________________1_1__1____1__________1___1__1__________________
136 _______________________________________________1______________11_________________________________________________1_1__1_____1________1___11111__________________
137 _______________________________________________1_____________1__________________________________________________1__1__1___11_________1_11_______________________
138 ________________________________________________1___________1___________________________________________________1__1__1111___________11_________________________
139 _________________________________________________1_________1_____________________________________________________1_1111_________________________________________
140 __________________________________________________1_______1______________________________________________________11_____________________________________________
141 ___________________________________________________11____1______________________________________________________________________________________________________
142 _____________________________________________________1__1_______________________________________________________________________________________________________
143 ______________________________________________________11________________________________________________________________________________________________________
144 ________________________________________________________________________________________________________________________________________________________________
145 ________________________________________________________________________________________________________________________________________________________________
146 ________________________________________________________________________________________________________________________________________________________________
147 ________________________________________________________________________________________________________________________________________________________________
148 ________________________________________________________________________________________________________________________________________________________________
149 ________________________________________________________________________________________________________________________________________________________________
150 ________________________________________________________________________________________________________________________________________________________________
151 ________________________________________________________________________________________________________________________________________________________________
152 ________________________________________________________________________________________________________________________________________________________________
153 ________________________________________________________________________________________________________________________________________________________________
154 ________________________________________________________________________________________________________________________________________________________________
155 ________________________________________________________________________________________________________________________________________________________________
156 ________________________________________________________________________________________________________________________________________________________________
157 ________________________________________________________________________________________________________________________________________________________________
158 ________________________________________________________________________________________________________________________________________________________________
159 ________________________________________________________________________________________________________________________________________________________________
160 ________________________________________________________________________________________________________________________________________________________________
161 ________________________________________________________________________________________________________________________________________________________________
162 ________________________________________________________________________________________________________________________________________________________________
163 ________________________________________________________________________________________________________________________________________________________________
164 ________________________________________________________________________________________________________________________________________________________________
165 ________________________________________________________________________________________________________________________________________________________________
166 ________________________________________________________________________________________________________________________________________________________________
167 ________________________________________________________________________________________________________________________________________________________________
