    0         10        20        30        40        50        60        70        80        90        100       110       120       130       140       150       
    0123456789012345678901234567890123456789012345678901234567890123456789012345678901234567890123456789012345678901234567890123456789012345678901234567890123456789
0   ________________________________________________________________________________________________________________________________________________________________
1   ________________________________________________________________________________________________________________________________________________________________
2   ________________________________________________________________________________________________________________________________________________________________
3   ________________________________________________________________________________________________________________________________________________________________
4   ________________________________________________________________________________________________________________________________________________________________
5   ________________________________________________________________________________________________________________________________________________________________
6   ________________________________________________________________________________________________________________________________________________________________
7   ________________________________________________________________________________________________________________________________________________________________
8   ________________________________________________________________________________________________________________________________________________________________
9   ________________________________________________________________________________________________________________________________________________________________
10  ________________________________________________________________________________________________________________________________________________________________
11  ________________________________________________________________________________________________________________________________________________________________
12  ________________________________________________________________________________________________________________________________________________________________
13  ________________________________________________________________________________________________________________________________________________________________
14  ________________________________________________________________________________________________________________________________________________________________
15  ________________________________________________________________________________________________________________________________________________________________
16  ________________________________________________________________________________________________________________________________________________________________
17  ________________________________________________________________________________________________________________________________________________________________
18  ________________________________________________________________________________________________________________________________________________________________
19  ________________________________________________________________________________________________________________________________________________________________
20  ________________________________________________________________________________________________________________________________________________________________
21  ________________________________________________________________________________________________________________________________________________________________
22  ________________________________________________________________________________________________________________________________________________________________
23  ________________________________________________________________________________________________________________________________________________________________
24  ________________________________________________________________________________________________________________________________________________________________
25  ________________________________________________________________________________________________________________________________________________________________
26  ________________________________________________________________________________________________________________________________________________________________
27  ________________________________________________________________________________________________________________________________________________________________
28  ________________________________________________________________________________________________________________________________________________________________
29  ________________________________________________________________________________________________________________________________________________________________
30  ________________________________________________________________________________________________________________________________________________________________
31  ________________________________________________________________________________________________________________________________________________________________
32  ________________________________________________________________________________________________________________________________________________________________
33  ________________________________________________________________________________________________________________________________________________________________
34  ________________________________________________________________________________________________________________________________________________________________
35  ________________________________________________________________________________________________________________________________________________________________
36  ________________________________________________________________________________________________________________________________________________________________
37  ________________________________________________________________________________________________________________________________________________________________
38  ________________________________________________________________________________________________________________________________________________________________
39  ________________________________________________________________________________________________________________________________________________________________
40  ________________________________________________________________________________________________________________________________________________________________
41  ________________________________________________________________________________________________________________________________________________________________
42  ________________________________________________________________________________________________________________________________________________________________
43  ________________________________________________________________________________________________________________________________________________________________
44  ________________________________________________________________________________________________________________________________________________________________
45  ________________________________________________________________________________________________________________________________________________________________
46  ________________________________________________________________________________________________________________________________________________________________
47  ________________________________________________________________________________________________________________________________________________________________
48  ________________________________________________________________________________________________________________________________________________________________
49  ________________________________________________________________________________________________________________________________________________________________
50  ________________________________________________________________________________________________________________________________________________________________
51  ________________________________________________________________________________________________________________________________________________________________
52  ________________________________________________________________________________________________________________________________________________________________
53  ________________________________________________________________________________________________________________________________________________________________
54  ________________________________________________________________________________________________________________________________________________________________
55  ________________________________________________________________________________________________________________________________________________________________
56  ________________________________________________________________________________________________________________________________________________________________
57  ________________________________________________________________________________________________________________________________________________________________
58  ________________________________________________________________________________________________________________________________________________________________
59  ________________________________________________________________________________________________________________________________________________________________
60  ________________________________________________________________________________________________________________________________________________________________
61  ________________________________________________________________________________________________________________________________________________________________
62  ________________________________________________________________________________________________________________________________________________________________
63  ________________________________________________________________________________________________________________________________________________________________
64  ________________________________________________________________________________________________________________________________________________________________
65  ________________________________________________________________________________________________________________________________________________________________
66  ________________________________________________________________________________________________________________________________________________________________
67  ________________________________________________________________________________________________________________________________________________________________
68  ________________________________________________________________________________________________________________________________________________________________
69  ________________________________________________________________________________________________________________________________________________________________
70  __________________________________________________________________________________________111111111111111111111111111111111111111111111111111111111111111111111_
71  __________________________________________________________________________________________1_____________________________________________________________________
72  __________________________________________________________________________________________1_____________________________________________________________________
73  __________________________________________________________________________________________1_____________________________________________________________________
74  __________________________________________________________________________________________1_____________________________________________________________________
75  __________________________________________________________________________________________1_____________________________________________________________________
76  __________________________________________________________________________________________1_____________________________________________________________________
77  __________________________________________________________________________________________1_____________________________________________________________________
78  __________________________________________________________________________________________1_____________________________________________________________________
79  __________________________________________________________________________________________1_____________________________________________________________________
80  __________________________________________________________________________________________1_____________________________________________________________________
81  __________________________________________________________________________________________1_____________________________________________________________________
82  __________________________________________________________________________________________1_____________________________________________________________________
83  __________________________________________________________________________________________1_____________________________________________________________________
84  __________________________________________________________________________________________1_____________________________________________________________________
85  __________________________________________________________________________________________1_____________________________________________________________________
86  __________________________________________________________________________________________1_____________________________________________________________________
87  __________________________________________________________________________________________1_____________________________________________________________________
88  __________________________________________________________________________________________1_____________________________________________________________________
89  __________________________________________________________________________________________1_____________________________________________________________________
90  __________________________________________________________________________________________1_____________________________________________________________________
91  __________________________________________________________________________________________1_____________________________________________________________________
92  __________________________________________________________________________________________1_____________________________________________________________________
93  __________________________________________________________________________________________1_____________________________________________________________________
94  __________________________________________________________________________________________1_____________________________________________________________________
95  __________________________________________________________________________________________1_____________________________________________________________________
96  __________________________________________________________________________________________1_____________________________________________________________________
97  __________________________________________________________________________________________1_____________________________________________________________________
98  __________________________________________________________________________________________1_____________________________________________________________________
99  __________________________________________________________________________________________1_____________________________________________________________________
100 __________________________________________________________________________________________1_____________________________________________________________________
101 __________________________________________________________________________________________1_____________________________________________________________________
102 __________________________________________________________________________________________1_____________________________________________________________________
103 __________________________________________________________________________________________1_____________________________________________________________________
104 __________________________________________________________________________________________1_____________________________________________________________________
105 __________________________________________________________________________________________1_____________________________________________________________________
106 __________________________________________________________________________________________1_____________________________________________________________________
107 __________________________________________________________________________________________1_____________________________________________________________________
108 __________________________________________________________________________________________1_____________________________________________________________________
109 __________________________________________________________________________________________1_____________________________________________________________________
110 __________________________________________________________________________________________1_________________________________________________11111111_____1111111
111 __________________________________________________________________________________________1_________________________________________________1______1_____1_____1
112 __________________________________________________________________________________________1_________________________________________________1______1_____1_____1
113 __________________________________________________________________________________________1_________________________________________________1______1_____1_____1
114 __________________________________________________________________________________________1_________________________________________________1______1_____1_____1
115 __________________________________________________________________________________________1_________________________________________________1______1_____1_____1
116 _______________________111________________________________________________________________1_____________________________________1___________1______1_____1_____1
117 _____________________11___11______________________________________________________________1_____________________________________1___________1______1_____1_____1
118 ___________________11_______11____________________________________________________________1______111111111_________________11111111_________1______1_____1_____1
119 _________________11___________1___________________________________________________________1______1______________________________1_1_________1______1_____1_____1
120 _________________11___________1__________________________________________1111111111111111111111111______1111111111111111111111___11_________1______1_____1_____1
121 ___________________111_____1111________________________________________1_________________1______11111111111111111111111111111111111_________1______1_____1_____1
122 ______________________11111__________________________________________3_1________________1_______1_________________________________1_________1______1_____1_____1
123 ____________________________________________________________________3331_______________1________1_________________________________1_________1______1_____1_____1
124 __________________________________________________________________333331______________1__________1_______________________________1__________1______1_____1_____1
125 _________________________________________________________________3333331_____________1___________1_______________________________1__________1______1_____1_____1
126 ________________________________________________________________33333331____________1____________1________________________________1_________1______1_____1_____1
127 _______________________________________________________________333333331___________1____________1_________________________________1_________1______1_____1_____1
128 _________________________________________________________________33333____________1_____________1__________________________________1________1______1_____1_____1
129 ________________________________________________________________333333_1_________1______________1_________________________________1_________1______1_____1_____1
130 _______________________________________________________________3333333_1________1________________1________________________________1_________1______1_____1_____1
131 ______________________________________________________________3333333__1_______1_________________1_______________________________1__________1______1_____1_____1
132 ____________________________________________________________333333333__1_____11__________________1_______________________________1__________1______1_____1_____1
133 ___________________________________________________________3333333333__1____1____________________1________________________________1_________1______1_____1_____1
134 ___________________________________________________________333333333___1___1____________________1_________________________________1_________1______1_____1_____1
135 ____________________________________________________________33333333______1_____________________1__________________________________1________1______1_____1_____1
136 _____________________________________________________________3333333___1_1______________________1__________________________________1________1______1_____1_____1
137 ______________________________________________________________33333____11_______________________1_________________________________1_________1______1_____1_____1
138 _____________________________________________________________333333333_1_________________________1________________________________1_________1______1_____1_____1
139 _______________________________________________________________3333___11_________________________1_______________________________1__________1______1_____1_____1
140 ________________________________________________________________33___1___________________________1_______________________________1__________1______1_____1_____1
141 _________________________________________________________________3__1____________________________1________________________________1_________1______1_____1_____1
142 ___________________________222222__________________________________1____________________________1_________________________________1_________1______1_____1_____1
143 _________________________22______2_______________________________3_1___________________1111111111__________________________________1111111111111___1_____1_____1
144 _______________________22_________2______________________________111_________________11_________1__________________________________1____________1__1_____1_____1
145 ______________________2_____________________________________________111111_________11___________________________________________________________1111111111111111
146 _____________________2______________2_____________________________________111111111_____________________________________________________________________________
147 ____________________2________________3__________________________________________________________________________________________________________________________
148 ___________________2________________33__________________________________________________________________________________________________________________________
149 __________________2________________3333_________________________________________________________________________________________________________________________
150 _________________2_______________3333333________________________________________________________________________________________________________________________
151 1111111111111____2______________333333333_______________________________________________________________________________________________________________________
152 1_____1_____1___2______________3333333333_______________________________________________________________________________________________________________________
153 1_____1_____1___2____________3333333333333______________________________________________________________________________________________________________________
154 1_____1_____1__2____________33333333333333______________________________________________________________________________________________________________________
155 1_____1_____1_32___________3333333333333333_____________________________________________________________________________________________________________________
156 1_____1_____1_2__________333333333333333333_____________________________________________________________________________________________________________________
157 1_____1_____1___________3333333333333333333_____________________________________________________________________________________________________________________
158 1_____1_____1_________3333333333333333333333____________________________________________________________________________________________________________________
159 1_____1_____1________33333333333333333333333____________________________________________________________________________________________________________________
160 1_____1_____1______333333333333333333333333333333333333333333333333333333333333333333333333333333333333333333333333333333333333333333333333333333333333333333333
161 1_____1_____1_____333333333333333333333333333333333333333333333333333333333333333333333333333333333333333333333333333333333333333333333333333333333333333333333_
162 1_____1_____1____3333333333333333333333333333333333333333333333333333333333333333333333333333333333333333333333333333333333333333333333333333333333333333333333_
163 1_____1_____1__333333333333333333333333333333333333333333333333333333333333333333333333333333333333333333333333333333333333333333333333333333333333333333333333_
164 1_____1_____1_3333333333333333333333333333333333333333333333333333333333333333333333333333333333333333333333333333333333333333333333333333333333333333333333333_
165 1_____1_____133333333333333333333333333333333333333333333333333333333333333333333333333333333333333333333333333333333333333333333333333333333333333333333333333_
166 1_____1____3133333333333333333333333333333333333333333333333333333333333333333333333333333333333333333333333333333333333333333333333333333333333333333333333333_
167 1111111111111333333333333333333333333333333333333333333333333333333333333333333333333333333333333333333333333333333333333333333333333333333333333333333333333333
