    0         10        20        30        40        50        60        70        80        90        100       110       120       130       140       150       
    0123456789012345678901234567890123456789012345678901234567890123456789012345678901234567890123456789012345678901234567890123456789012345678901234567890123456789
0   ________________________________________________________________________________________________________________________________________________________________
1   ________________________________________________________________________________________________________________________________________________________________
2   ________________________________________________________________________________________________________________________________________________________________
3   ________________________________________________________________________________________________________________________________________________________________
4   ________________________________________________________________________________________________________________________________________________________________
5   ________________________________________________________________________________________________________________________________________________________________
6   ________________________________________________________________________________________________________________________________________________________________
7   ________________________________________________________________________________________________________________________________________________________________
8   ________________________________________________________________________________________________________________________________________________________________
9   ________________________________________________________________________________________________________________________________________________________________
10  ________________________________________________________________________________________________________________________________________________________________
11  ________________________________________________________________________________________________________________________________________________________________
12  ________________________________________________________________________________________________________________________________________________________________
13  ________________________________________________________________________________________________________________________________________________________________
14  ________________________________________________________________________________________________________________________________________________________________
15  ________________________________________________________________________________________________________________________________________________________________
16  ________________________________________________________________________________________________________________________________________________________________
17  ________________________________________________________________________________________________________________________________________________________________
18  ________________________________________________________________________________________________________________________________________________________________
19  ________________________________________________________________________________________________________________________________________________________________
20  ________________________________________________________________________________________________________________________________________________________________
21  ________________________________________________________________________________________________________________________________________________________________
22  ________________________________________________________________________________________________________________________________________________________________
23  ________________________________________________________________________________________________________________________________________________________________
24  ________________________________________________________________________________________________________________________________________________________________
25  ________________________________________________________________________________________________________________________________________________________________
26  ________________________________________________________________________________________________________________________________________________________________
27  ________________________________________________________________________________________________________________________________________________________________
28  ________________________________________________________________________________________________________________________________________________________________
29  ________________________________________________________________________________________________________________________________________________________________
30  ________________________________________________________________________________________________________________________________________________________________
31  ________________________________________________________________________________________________________________________________________________________________
32  ________________________________________________________________________________________________________________________________________________________________
33  ________________________________________________________________________________________________________________________________________________________________
34  ________________________________________________________________________________________________________________________________________________________________
35  ________________________________________________________________________________________________________________________________________________________________
36  ________________________________________________________________________________________________________________________________________________________________
37  ________________________________________________________________________________________________________________________________________________________________
38  ________________________________________________________________________________________________________________________________________________________________
39  ________________________________________________________________________________________________________________________________________________________________
40  ________________________________________________________________________________________________________________________________________________________________
41  ________________________________________________________________________________________________________________________________________________________________
42  ________________________________________________________________________________________________________________________________________________________________
43  ________________________________________________________________________________________________________________________________________________________________
44  ________________________________________________________________________________________________________________________________________________________________
45  ________________________________________________________________________________________________________________________________________________________________
46  ________________________________________________________________________________________________________________________________________________________________
47  ________________________________________________________________________________________________________________________________________________________________
48  ________________________________________________________________________________________________________________________________________________________________
49  ________________________________________________________________________________________________________________________________________________________________
50  ________________________________________________________________________________________________________________________________________________________________
51  ________________________________________________________________________________________________________________________________________________________________
52  ________________________________________________________________________________________________________________________________________________________________
53  ________________________________________________________________________________________________________________________________________________________________
54  ________________________________________________________________________________________________________________________________________________________________
55  ________________________________________________________________________________________________________________________________________________________________
56  ________________________________________________________________________________________________________________________________________________________________
57  ______________________________________________________________________________________________________________________________________________________1111______
58  ___________________________________________________________________________________________________________________________________________________111_1__111___
59  ________________________________________________________________________________________________________________________________________________________________
60  _____________________________________________________________________________________________________________________________________________________11111______
61  ________________________________________________________________________________________________________________________________________________________________
62  ________________________________________________________________________________________________________________________________________________________________
63  ________________________________________________________________________________________________________________________________________________________________
64  ________________________________________________________________________________________________________________________________________________________________
65  __________________________________________________________________________________________________________________________________________________222222________
66  _______________________________________________________________________________________________________________________________________________222______2222222_
67  ____________________________________________________________________________________________________________________________________________222_________________
68  _________________________________________________________________________________________________________________________________________1_22___________________
69  ________________________________________________________________________________________________________________________________________1222____________________
70  _______________________________________________________________________________________________________________________________________12_2_____________________
71  ______________________________________________________________________________________________________________________________________1222______________________
72  __11111111111111111111111111__________________________________________________________________________________________________________12________________________
73  ____1___11111___11111___1__1_________________________________________________________________________________________________________12_________________________
74  ____1___1___1___1___1___1__1________________________________________________________________________________________________________12__________________________
75  ____1___1___1___1___1___1__1________________________________________________________________________________________________________1___________________________
76  ____1___1___1___1___1___1__1_______________________________________________________________________________________________________12___________________________
77  ____1___1___1___1___1___1__1_______________________________________________________________________________________________________1____________________________
78  _11_1___1___1___1___1___1__1_______________________________________________________________________________________________________1____________________________
79  ___111111___1___1___1___111_______________________________________________________________________________________________________12_______________333_________3
80  _____111111_11111__111111_________________________________________________________________________________________________________12____________333333_______333
81  ___________11111111______________________________________________________________________________________________________________12_________________________3333
82  _______________________________________________________________________________________111111111______________111111111111111111111________333333333333333333333
83  ____________________________________________________________________________________111_________111___________1__________________________33333333333333333333333
84  ____________________________________________________________________________________1______________11_________1________11111111111111111_33333333333333333333333
85  _____________________________________________________________________________________1____________11__________111111111________________1_11222222233333333333333
86  _____________________________________________________________________________________1111111111111_________________11111111111111111111______3333233333333333333
87  ______________________________________________________________________________________________________________________________________________333233333333333333
88  ______________________________________________________________________________________________________________________________________________333233333333333333
89  _________________________________________________________________________________________________________________222222222____________________333233333333333333
90  _____________________________________________________________________________________________________________2222_________22222222222222222222_22233333333333333
91  __________________________________________________________________________________________________________222__________________________________33333333333333333
92  ________________________________________________________________________________________________________22______________________________________3333333333333333
93  _______________________________________________________________________________________________________2________________________________________3333333333333333
94  ______________________________________________________________________________________________________2__________________________________________333333333333333
95  _____________________________________________________________________________________________________2___________________________________________333333333333333
96  _111111111111111111_________________________________________________________________________________2________________________________33333333333333_____33333333
97  ____1___11111___1__1__________________________________________________________________________________________33333333333333333333333333333333333_______33333333
98  ____1___1___1___1__1________________________________________________________________________3333333333333333333333333333333333333333333333333333_________3333333
99  ____1___1___1___1___1_______________________________________________________________________3333333333333333333333333333333333333333333333333333_________3333333
100 ____1___1___1___1___1_________________________________________1111111111111111111111111____333333333333333333333333333333333333333333333333333____________333333
101 _11111111___1___1____1________________________________________1_______________________1___333333333333333333333333333333333333333333333333333_____________333333
102 ___11111111111111___1_________________________________________1_______________________1___33333333333333333333333333333333333333333333333333___11111111____33333
103 ___1___1_____1111__1__________________________________________1__________________________3333333333333333333333333333333333333333333333333311111___11111111_3333
104 1111111111111111111___________________________________________1_______________________1__3333333333333333333333333333333333333333333333333313__1___1___1___11333
105 ______________________________________________________________1_______________________1_33333333333333333333333333333333333333333333333333313331___1___1____1333
106 ______________________________________________________________1_______________________1_333333333333333333333333333333333333333333333333333133311111___1__331333
107 ______________________________________________________________111111____________11_1111_333333333333333333333333333333333333333333333333333111111111111111111333
108 ____________________________________________________________________111111111111________333333333333333333333333333333333333333333333333333333333333333333333333
109 _________________________________________________________________________________________33333333333333333333333333333333333333333333333333333333333333333333333
110 _________________________________________________________________________________________33333333333333333333333333333333333333333333333333333333333333333333333
111 ___________________________________________________________________________________________333333333333333333333333333333333333333333333333333333333333333333333
112 ______________________________________________________________________________________________333333333333333333333333333333333333333333333333333333333333333333
113 ______________________________________________________________________________________________333333333333333333333333333333333333333333333333333333333333333333
114 _______________________________________________________________________________________________33333333333333333333333333333333333333333333333333333333333333333
115 ________________________________________________________________________________________________3333333333333333333333333333333333333333333333333333333333333333
116 ______________________________11111111111________________________________________________________333333333333333333333333333333333333333333333333333333333333333
117 __________________________1111___________11111____________________________________________________33333333333333333333333333333333333333333333333333333333333333
118 ________________________11____________________11____________________________________________________333333333333333333333333333333333333333333333333333333333333
119 _______________________1_______________________11____________________________________________________33333333333333333333333333333333333333333333333333333333333
120 _______________________11____________________11_______________________________________________________3333333333333333333333333333333333333333333333333333333333
121 _________________________11_______________111_________________________________________________________3333333333333333333333333333333333333333333333333333333333
122 ___________________________11__________111_____________________________________________________________333333333333333333333333333333333333333333333333333333333
123 _____________________________1111111111_________________________________________________________________33333333333333333333333333333333333333333333333333333333
124 ________________________________________________________________________________________________________33333333333333333333333333333333333333333333333333333333
125 __________________________________________________________________________________________________________333333333333333333333333333333333333333333333333333333
126 __________________________________________________________________________________________________________333333333333333333333333333333333333333333333333333333
127 __________________________________________________________________________________________________________333333333333333333333333333333333333333333333333333333
128 __________________________________________________________________________________________________________333333333333333333333333333333333333333333333333333333
129 __________________________________________________________________________________________________________333333333333333333333333333333333333333333333333333333
130 __________________________________________________________________________________________________________333333333333333333333333333333333333333333333333333333
131 __________________________________________________________________________________________________________333333333333333333333333333333333333333333333333333333
132 __________________________________________________________________________________________________________333333333333333333333333333333333333333333333333333333
133 __________________________________________________________________________________________________________333333333333333333333333333333333333333333333333333333
134 __________________________________________________________________________________________________________333333333333333333333333333333333333333333333333333333
135 ___________________________________________________________________________________________________________33333333333333333333333333333333333333333333333333333
136 ___________________________________________________________________________________________________________33333333333333333333333333333333333333333333333333333
137 ___________________________________________________________________________________________________________33333333333333333333333333333333333333333333333333333
138 ___________________________________________________________________________________________________________33333333333333333333333333333333333333333333333333333
139 ____________________________________________________________________________________________________________3333333333333333333333333333333333333333333333333333
140 ____________________________________________________________________________________________________________3333333333333333333333333333333333333333333333333333
141 ____________________________________________________________________________________________________________3333333333333333333333333333333333333333333333333333
142 ____________________________________________________________________________________________________________3333333333333333333333333333333333333333333333333333
143 ____________________________________________________________________________________________________________3333333333333333333333333333333333333333333333333333
144 _____________________________________________________________________________________________________________333333333333333333333333333333333333333333333333333
145 _____________________________________________________________________________________________________________333333333333333333333333333333333333333333333333333
146 _____________________________________________________________________________________________________________333333333333333333333333333333333333333333333333333
147 _____________________________________________________________________________________________________________333333333333333333333333333333333333333333333333333
148 _____________________________________________________________________________________________________________333333333333333333333333333333333333333333333333333
149 _____________________________________________________________________________________________________________333333333333333333333333333333333333333333333333333
150 ______________________________________________________________________________________________________________33333333333333333333333333333333333333333333333333
151 ______________________________________________________________________________________________________________33333333333333333333333333333333333333333333333333
152 ______________________________________________________________________________________________________________33333333333333333333333333333333333333333333333333
153 ______________________________________________________________________________________________________________33333333333333333333333333333333333333333333333333
154 _______________________________________________________________________________________________________________3333333333333333333333333333333333333333333333333
155 _______________________________________________________________________________________________________________3333333333333333333333333333333333333333333333333
156 ________________________________________________________________________________________________________________333333333333333333333333333333333333333333333333
157 ________________________________________________________________________________________________________________333333333333333333333333333333333333333333333333
158 _________________________________________________________________________________________________________________33333333333333333333333333333333333333333333333
159 _________________________________________________________________________________________________________________33333333333333333333333333333333333333333333333
160 __________________________________________________________________________________________________________________3333333333333333333333333333333333333333333333
161 __________________________________________________________________________________________________________________3333333333333333333333333333333333333333333333
162 ___________________________________________________________________________________________________________________333333333333333333333333333333333333333333333
163 _____________________________________________________________________________________________________________________3333333333333333333333333333333333333333333
164 ________________________________________________________________________________________________________________________3333333333333333333333333333333333333333
165 ___________________________________________________________________________________________________________________________3333333333333333333333333333333333333
166 _____________________________________________________________________________________________________________________________33333333333333333333333333333333333
167 ______________________________________________________________________________________________________________________________3333333333333333333333333333333333
