    0         10        20        30        40        50        60        70        80        90        100       110       120       130       140       150       
    0123456789012345678901234567890123456789012345678901234567890123456789012345678901234567890123456789012345678901234567890123456789012345678901234567890123456789
0   ________________________________________________________________________________________________________________________________________________________________
1   ________________________________________________________________________________________________________________________________________________________________
2   ________________________________________________________________________________________________________________________________________________________________
3   ________________________________________________________________________________________________________________________________________________________________
4   ________________________________________________________________________________________________________________________________________________________________
5   ________________________________________________________________________________________________________________________________________________________________
6   ________________________________________________________________________________________________________________________________________________________________
7   ________________________________________________________________________________________________________________________________________________________________
8   ________________________________________________________________________________________________________________________________________________________________
9   ________________________________________________________________________________________________________________________________________________________________
10  ________________________________________________________________________________________________________________________________________________________________
11  ________________________________________________________________________________________________________________________________________________________________
12  ________________________________________________________________________________________________________________________________________________________________
13  ________________________________________________________________________________________________________________________________________________________________
14  ________________________________________________________________________________________________________________________________________________________________
15  ________________________________________________________________________________________________________________________________________________________________
16  ________________________________________________________________________________________________________________________________________________________________
17  ________________________________________________________________________________________________________________________________________________________________
18  ________________________________________________________________________________________________________________________________________________________________
19  ________________________________________________________________________________________________________________________________________________________________
20  ________________________________________________________________________________________________________________________________________________________________
21  ________________________________________________________________________________________________________________________________________________________________
22  ________________________________________________________________________________________________________________________________________________________________
23  ________________________________________________________________________________________________________________________________________________________________
24  ________________________________________________________________________________________________________________________________________________________________
25  ________________________________________________________________________________________________________________________________________________________________
26  ________________________________________________________________________________________________________________________________________________________________
27  ________________________________________________________________________________________________________________________________________________________________
28  ________________________________________________________________________________________________________________________________________________________________
29  ________________________________________________________________________________________________________________________________________________________________
30  ________________________________________________________________________________________________________________________________________________________________
31  ________________________________________________________________________________________________________________________________________________________________
32  ________________________________________________________________________________________________________________________________________________________________
33  ________________________________________________________________________________________________________________________________________________________________
34  ________________________________________________________________________________________________________________________________________________________________
35  ________________________________________________________________________________________________________________________________________________________________
36  ________________________________________________________________________________________________________________________________________________________________
37  ________________________________________________________________________________________________________________________________________________________________
38  ________________________________________________________________________________________________________________________________________________________________
39  ________________________________________________________________________________________________________________________________________________________________
40  ________________________________________________________________________________________________________________________________________________________________
41  ________________________________________________________________________________________________________________________________________________________________
42  ________________________________________________________________________________________________________________________________________________________________
43  ________________________________________________________________________________________________________________________________________________________________
44  ________________________________________________________________________________________________________________________________________________________________
45  ________________________________________________________________________________________________________________________________________________________________
46  ________________________________________________________________________________________________________________________________________________________________
47  ________________________________________________________________________________________________________________________________________________________________
48  ________________________________________________________________________________________________________________________________________________________________
49  ________________________________________________________________________________________________________________________________________________________________
50  ________________________________________________________________________________________________________________________________________________________________
51  ________________________________________________________________________________________________________________________________________________________________
52  ________________________________________________________________________________________________________________________________________________________________
53  ________________________________________________________________________________________________________________________________________________________________
54  ________________________________________________________________________________________________________________________________________________________________
55  ________________________________________________________________________________________________________________________________________________________________
56  ________________________________________________________________________________________________________________________________________________________________
57  ________________________________________________________________________________________________________________________________________________________________
58  ________________________________________________________________________________________________________________________________________________________________
59  ________________________________________________________________________________________________________________________________________________________________
60  _________________________________________________________________________________________________111111111111111111111111111111111111111111111111111111111111111
61  ________________________________________________________________________________________________1_1_____1_____1____________________________1____1____1____1_____
62  ________________________________________________________________________________________________1_1_____1_____1____________________________1____1____1____1_____
63  _______________________________________________________________________________________________1__1_____1_____1____________________________1____1____1____1_____
64  ______________________________________________________________________________________________1___1_____1_____1____________________________1____1____1____1_____
65  ______________________________________________________________________________________________1___1_____1_____1____________________________1____1____1____1_____
66  _____________________________________________________________________________________________1____1_____1_____1____________________________1____1____1____1_____
67  ____________________________________________________________________________________________11____1_____1_____1____________________________1____1____1____1_____
68  ____________________________________________________________________________________________11____1_____1_____1____________________________1____1____1____1_____
69  ___________________________________________________________________________________________1_1____1_____1_____1____________________________1____1____1____1_____
70  ___________________________________________________________________________________________1_1____1_____1_____1____________________________1____1____1____1_____
71  __________________________________________________________________________________________1__1____1_____1_____1____________________________1____1____1____1_____
72  ___1111111111111111111111________________________________________________________________1___1____1_____1_____1____________________________1____1____1____1_____
73  ___1__1___1___1___1_____1________________________________________________________________1___1____1_____1_____1____________________________1____1____1____1_____
74  ___1__1___1___1___1_____1_______________________________________________________________1____1____1_____1_____1____________________________1____1____1____1_____
75  ___1__1___1___1___1_____1______________________________________________________________1_____1____1_____1_____1____________________________1____1____1____1_____
76  ___1__1___1___1___1_____1______________________________________________________________1_____1____1_____1_____1____________________________1____1____1____1_____
77  ___1__1___1___1___1_____1_____________________________________________________________1______1____1_____1_____1____________________________1____1____1____1_____
78  ___1__1___1___1___1_____1____________________________________________________________11______1____1_____1_____1____________________________1____1____1____1_____
79  ___11_1___1___1___1_____1____________________________________________________________11______1____1__1111111111111111111111111111111111111111111111111111111111_
80  _____11___1___1___1____1____________________________________________________________1_1______1____111_____________________________________1___1___1___1___1_____
81  ______1___11111___1_111____________________________________________________________1__1______1___11_______________________________________1___1___1___1___1_____
82  _______1111111111111_______________________________________________________________1__1______1111_1_______________________________________1___1___1___1___1_____
83  __________________________________________________________________________________1___1_____11____1_______________________________________1___1___1___1___1_____
84  __________________________________________________________________________________1___1__111_1____1_______________________________________1___1___1___1___1_____
85  _________________________________________________________________________________11___111____1____1_______________________________________1___1___1___1___1_____
86  ________________________________________________________________________________1_1__11______1____1_______________________________________1___1___1___1___1_____
87  ________________________________________________________________________________1_111_1______1____1_______________________________________1___1___1___1___1_____
88  _______________________________________________________________________________1_11___1______1____1_______________________________________1___1___1___1___1_____
89  ______________________________________________________________________________1_1_1___1______1____1_______________________________________1___1___1___1___1_____
90  ______________________________________________________________________________11__1___1______1____1_______________________________________1___1___1___1___1_____
91  _______________________________1111111_______________________________________11___1___1______1____1_______________________________________1___1___1___1___1_____
92  ___________________________1111_______111__________________________11111111111____1___1______1____1_______________________________________1___1___1___1___1_____
93  __________________________1_____________1______________________1111__1_______1____1___1______1____1_________________________1_____________1___1___1___1___1_____
94  _________________________1______________1___________________111______1_______1____1___1______1____1________________________1_1____________1___1___1___11111_____
95  ________________________1______________11___________________111111111111111111111111111111111111111111111111111111111111111___111111111111111111111111111111111_
96  ________________________11___________11_________________________________________________________________________________________________________________________
97  __________________________111____1111___________________________________________________________________________________________________________________________
98  _____________________________1111_______________________________________________________________________________________________________________________________
99  ________________________________________________________________________________________________________________________________________________________________
100 ________________________________________________________________________________________________________________________________________________________________
101 ________________________________________________________________________________________________________________________________________________________________
102 ________________________________________________________________________________________________________________________________________________________________
103 ________________________________________________________________________________________________________________________________________________________________
104 ________________________________________________________________________________________________________________________________________________________________
105 ____________________________________________________________________________________________________________________________1111111111111_______________________
106 ___________________________________________________________________________________________________________________________1_____________111____________________
107 _________________________________________________________________________________________________________________________11________________1____________________
108 __________________________________________________________________________________________________________________________11111_______1111_1____________________
109 _______________________________________________________________________________________________________________________________1111111____11____________________
110 ___________________________________________________________________________________________________________________________________________1____________________
111 ________________________________________________________________________________________________________________________________________________________________
112 ________________________________________________________________________________________________________________________________________________________________
113 ________________________________________________________________________________________________________________________________________________________________
114 ________________________________________________________________________________________________________________________________________________________________
115 ________________________________________________________________________________________________________________________________________________________________
116 ________________________________________________________________________________________________________________________________________________________________
117 ________________________________________________________________________________________________________________________________________________________________
118 ________________________________________________________________________________________________________________________________________________________________
119 ________________________________________________________________________________________________________________________________________________________________
120 ________________________________________________________________________________________________________________________________________________________________
121 ________________________________________________________________________________________________________________________________________________________________
122 ________________________________________________________________________________________________________________________________________________________________
123 ________________________________________________________________________________________________________________________________________________________________
124 ________________________________________________________________________________________________________________________________________________________________
125 ________________________________________________________________________________________________________________________________________________________________
126 ________________________________________________________________________________________________________________________________________________________________
127 ________________________________________________________________________________________________________________________________________________________________
128 ________________________________________________________________________________________________________________________________________________________________
129 ________________________________________________________________________________________________________________________________________________________________
130 ________________________________________________________________________________________________________________________________________________________________
131 ________________________________________________________________________________________________________________________________________________________________
132 ________________________________________________________________________________________________________________________________________________________________
133 _____________________________________________________________________________111________________________________________________________________________________
134 ____________________________________________________________________________1___1_______________________________________________________________________________
135 ___________________________________________________________________________1____1_______________________________________________________________________________
136 _________________________________________________________________________11______1______________________________________________________________________________
137 _______________________________________________________________________11_________1_____________________________________________________________________________
138 ______________________________________________________________________1____________1____________________________________________________________________________
139 ______________________________________________________________________1____________1____________________________________________________________________________
140 _______________________________________________________________________1__________1_____________________________________________________________________________
141 ________________________________________________________________________1_________1_______________1111111_______________________________________________________
142 _________________________________________________________________________11_____11_________________1____1_______________________________________________________
143 ___________________________________________________________________________1__11___________________1____1_______________________________________________________
144 ____________________________________________________________________________11_____________________1___11_______________________________________________________
145 ___________________________________________________________________________________________________1111_________________________________________________________
146 ________________________________________________________________________________________________________________________________________________________________
147 ________________________________________________________________________________________________________________________________________________________________
148 ________________________________________________________________________________________________________________________________________________________________
149 ________________________________________________________________________________________________________________________________________________________________
150 ________________________________________________________________________________________________________________________________________________________________
151 ________________________________________________________________________________________________________________________________________________________________
152 ________________________________________________________________________________________________________________________________________________________________
153 ________________________________________________________________________________________________________________________________________________________________
154 ________________________________________________________________________________________________________________________________________________________________
155 ________________________________________________________________________________________________________________________________________________________________
156 ________________________________________________________________________________________________________________________________________________________________
157 ________________________________________________________________________________________________________________________________________________________________
158 ________________________________________________________________________________________________________________________________________________________________
159 ________________________________________________________________________________________________________________________________________________________________
160 ________________________________________________________________________________________________________________________________________________________________
161 ________________________________________________________________________________________________________________________________________________________________
162 ________________________________________________________________________________________________________________________________________________________________
163 ________________________________________________________________________________________________________________________________________________________________
164 ________________________________________________________________________________________________________________________________________________________________
165 ________________________________________________________________________________________________________________________________________________________________
166 ________________________________________________________________________________________________________________________________________________________________
167 ________________________________________________________________________________________________________________________________________________________________
