    0         10        20        30        40        50        60        70        80        90        100       110       120       130       140       150       
    0123456789012345678901234567890123456789012345678901234567890123456789012345678901234567890123456789012345678901234567890123456789012345678901234567890123456789
0   ________________________________________________________________________________________________________________________________________________________________
1   ________________________________________________________________________________________________________________________________________________________________
2   ________________________________________________________________________________________________________________________________________________________________
3   ________________________________________________________________________________________________________________________________________________________________
4   ________________________________________________________________________________________________________________________________________________________________
5   ________________________________________________________________________________________________________________________________________________________________
6   ________________________________________________________________________________________________________________________________________________________________
7   ________________________________________________________________________________________________________________________________________________________________
8   ________________________________________________________________________________________________________________________________________________________________
9   ________________________________________________________________________________________________________________________________________________________________
10  ________________________________________________________________________________________________________________________________________________________________
11  ________________________________________________________________________________________________________________________________________________________________
12  ________________________________________________________________________________________________________________________________________________________________
13  ________________________________________________________________________________________________________________________________________________________________
14  ________________________________________________________________________________________________________________________________________________________________
15  ________________________________________________________________________________________________________________________________________________________________
16  ________________________________________________________________________________________________________________________________________________________________
17  ________________________________________________________________________________________________________________________________________________________________
18  ________________________________________________________________________________________________________________________________________________________________
19  ________________________________________________________________________________________________________________________________________________________________
20  ________________________________________________________________________________________________________________________________________________________________
21  ________________________________________________________________________________________________________________________________________________________________
22  ________________________________________________________________________________________________________________________________________________________________
23  ________________________________________________________________________________________________________________________________________________________________
24  ________________________________________________________________________________________________________________________________________________________________
25  ________________________________________________________________________________________________________________________________________________________________
26  ________________________________________________________________________________________________________________________________________________________________
27  ________________________________________________________________________________________________________________________________________________________________
28  ________________________________________________________________________________________________________________________________________________________________
29  ________________________________________________________________________________________________________________________________________________________________
30  ________________________________________________________________________________________________________________________________________________________________
31  ________________________________________________________________________________________________________________________________________________________________
32  ________________________________________________________________________________________________________________________________________________________________
33  ________________________________________________________________________________________________________________________________________________________________
34  ________________________________________________________________________________________________________________________________________________________________
35  ________________________________________________________________________________________________________________________________________________________________
36  ________________________________________________________________________________________________________________________________________________________________
37  ________________________________________________________________________________________________________________________________________________________________
38  ________________________________________________________________________________________________________________________________________________________________
39  ________________________________________________________________________________________________________________________________________________________________
40  ________________________________________________________________________________________________________________________________________________________________
41  ________________________________________________________________________________________________________________________________________________________________
42  ________________________________________________________________________________________________________________________________________________________________
43  ________________________________________________________________________________________________________________________________________________________________
44  ________________________________________________________________________________________________________________________________________________________________
45  ________________________________________________________________________________________________________________________________________________________________
46  ____________111111111111111111111111111111111111________________________________________________________________________________________________________________
47  ____________1_____1_______1_____1______1_____1__1_______________________________________________________________________________________________________________
48  ____________1_____1_______1_____1______1_____1___1_______________________________________________________________________________________1111111111111111111111_
49  ____________1_____1_______1_____1______1_____1____1______________________________________________________________________________________1___1___1___1___1___11_
50  ____________1_____1_______1_____1______1_____1____1______________________________________________________________________________________1___1___1___1___1___11_
51  ____________1_____1_______1_____1______1_____1____1______________________________________________________________________________________1___1___1___1___1___11_
52  ___________1______1_______1_____1______1_____1____1______________________________________________________________________________________1___1___1___1___1___11_
53  ___________1______11111___1_____1______1_____1____1______________________________________________________________________________________1___1___1___1___1___11_
54  ___________1____111_1__1111_____1____11111111111111_______________________________________________________________________________________11_1___1___1___1___11_
55  ___________1_111____1___1111111_1_111___1___1_____1_________________________________________________________________________________________111111___1___1___11_
56  ___________11_______1___1___1__111111___1___1____11____________________________________________________________________________________________1111__1111111111_
57  ___________1________1___1___1___1___1___1___1__111_________________________________________________________________________________________________11___________
58  ___________1________1___1___1___1___11111___1_1__1______________________________________________________________________________________________________________
59  ___________1111_____1___1___1___1__11111111111111_______________________________________________________________________________________________________________
60  _______________1111111111___1111111_____________________________________________________________________________________________________________________________
61  _______________________111111___________________________________________________________________________________________________________________________________
62  ________________________________________________________________________________________________________________________________________________________________
63  ________________________________________________________________________________________________________________________________________________________________
64  ________________________________________________________________________________________________________________________________________________________________
65  ________________________________________________________________________________________________________________________________________________________________
66  ________________________________________________________________________________________________________________________________________________________________
67  ________________________________________________________________________________________________________________________________________________________________
68  ___________________________________________________________________________1111111111111111111111111111111111111111111111111111111______________________________
69  _________________________________________________________________________11_______________________________________________________11____________________________
70  _______________________________________________________________________11___________________________________________________________11__________________________
71  ___________________________________________________________________111111111111111111111111111111111111111111111111111111111111111111111________________________
72  _________________________________________________________11111111111___________________________________________________________________111111111111111111111111_
73  _________________________________________________________1_____111________________________________________________________________________111___________________
74  _________________________________________________________1___11______________________________________________________________________________11_________________
75  _________________________________________________________1_11__________________________________________________________________________________11_______________
76  ________________________________________________________111______________________________________________________________________________________11_____________
77  ______________________________________________________111__________________________________________________________________________________________11___________
78  ___________________________________________________111__1____________________________________________________________________________________________1111111111_
79  _________________________________________________11_____1_______________________________________________________________________________________________________
80  _______________________________________________11_______1_______________________________________________________________________________________________________
81  ____________________________________________111_________1_______________________________________________________________________________________________________
82  __________________________________________11____________1_______________________________________________________________________________________________________
83  ________________________________________11__________11111_______________________________________________________________________________________________________
84  _________________________________________1__________1___________________________________________________________________________________________________________
85  _________________________________________1__________1___________________________________________________________________________________________________________
86  __________________________________________1_________1___________________________________________________________________________________________________________
87  __________________________________________1_________1___________________________________________________________________________________________________________
88  ___________________________________________1________1___________________________________________________________________________________________________________
89  ___________________________________________1________1___________________________________________________________________________________________________________
90  ____________________________________________1_______1___________________________________________________________________________________________________________
91  ____________________________________________1_______1___________________________1111____________________________________________________________________________
92  _____________________________________________1______1_________________________11__1_111_________________________________________________________________________
93  _____________________________________________1______1_______________________11____1____1________________________________________________________________________
94  ______________________________________________1_____1_______________________1_____1_____11______________________________________________________________________
95  ______________________________________________1_____1______________________1______1_______1_____________________________________________________________________
96  _______________________________________________1____1_____________________11______1______1______________________________________________________________________
97  _______________________________________________1____1_____________________11______1______1______________________________________________________________________
98  ________________________________________________1___1_______________________1_____1_____1_______________________________________________________________________
99  ________________________________________________1___1________________________1____1_____1_______________________________________________________________________
100 _________________________________________________1__1_________________________1___1___11________________________________________________________________________
101 _________________________________________________1__1__________________________1111111__________________________________________________________________________
102 __________________________________________________1_1___________________________________________________________________________________________________________
103 __________________________________________________1_1___________________________________________________________________________________________________________
104 ___________________________________________________11___________________________________________________________________________________________________________
105 ___________________________________________________11___________________________________________________________________________________________________________
106 ____________________________________________________1___________________________________________________________________________________________________________
107 ____________________________________________________111_________________________________________________________________________________________________________
108 ______________________________________________________1111111111111111111_______________________________________________________________________________________
109 _______________________________________________________1________________1_______________________________________________________________________________________
110 _______________________________________________________1________________1_______________________________________________________________________________________
111 ________________________________________________________1_______________1_______________________________________________________________________________________
112 _________________________________________________________1______________1_______________________________________________________________________________________
113 __________________________________________________________1_____________1_______________________________________________________________________________________
114 ___________________________________________________________1____________1_______________________________________________________________________________________
115 ____________________________________________________________1___________1_______________________________________________________________________________________
116 _____________________________________________________________1__________1_______________________________________________________________________________________
117 _________1111111______________________________________________1_________1_______________________________________________________________________________________
118 ____11111___111111111_________________________________________1_________1_______________________________________________________________________________________
119 ____1___1___1___1____11111_____________________________________1________1_______________________________________________________________________________________
120 ____1___1___1___1_________111___________________________________1_______1_______________________________________________________________________________________
121 _____1__1___1___1__________1_____________________________________1______1_______________________________________________________________________________________
122 _____1__1___1___1_________1_______________________________________1_____1_______________________________________________________________________________________
123 _____1__1___1___1________1_________________________________________1____1_______________________________________________________________________________________
124 _____1__1___1___1________1__________________________________________1___1_______________________________________________________________________________________
125 ______1_11111___1_______1____________________________________________1__1_______________________________________________________________________________________
126 ______111111111111111111_____________________________________________1__1_______________________________________________________________________________________
127 ______________________________________________________________________1_1___________________________________________11__________________________________________
128 _______________________________________________________________________11___________________________________________1_11________________________________________
129 ________________________________________________________________________1111111111111111111111111111111111111111111_1___111_____________________________________
130 ________________________________________________________________________1__________________________________________11_____11111111111111111111111111____________
131 ________________________________________________________________________11111111111111111111111111111111111111111111111______11111_____1______1_____1___________
132 _______________________________________________________________________________________________________________________11______11_111__1______1_____11__________
133 _________________________________________________________________________________________________________________________11______111_1111_____1_____1_1_________
134 ___________________________________________________________________________________________________________________________11_______11_1_111__1_____1__1________
135 _____________________________________________________________________________________________________________________________11_______11____1111____1___1_______
136 _______________________________________________________________________________________________________________________________11______1111___1_11__1____1______
137 _________________________________________________________________________________________________________________________________11____1___11_1___111____11_____
138 ___________________________________________________________________________________________________________________________________11__1_____11_____1____1_1____
139 _____________________________________________________________________________________________________________________________________111______1111__11___1__1___
140 _______________________________________________________________________________________________________________________________________11_____1___111_11_1___1__
141 _________________________________________________________________________________________________________________________________________11___1_____11__11____1_
142 ___________________________________________________________________________________________________________________________________________11_1_____1_11_11____1
143 _____________________________________________________________________________________________________________________________________________11_____1___11_1___1
144 _______________________________________________________________________________________________________________________________________________11___1____1__1__1
145 _________________________________________________________________________________________________________________________________________________1__1____11__111
146 __________________________________________________________________________________________________________________________________________________111____1_1___1
147 ___________________________________________________________________________________________________________________________________________________11____1__1__1
148 _____________________________________________________________________________________________________________________________________________________1___1___1_1
149 ______________________________________________________________________________________________________________________________________________________1__1____11
150 ____________________________________________________________________________________________________111111111111_______________________________________111___111
151 ________________________________________________________________________________________________1111__1______1__11_______________________________________1111_11
152 ______________________________________________________________________________________________11______1______1____1_______________________________________1___1_
153 _____________________________________________________________________________________________1________1______1____1________________________________________11_1_
154 ____________________________________________________________________________________________1_________1______1____1__________________________________________11_
155 ____________________________________________________________________________________________11________1______1____1___________________________________________1_
156 ______________________________________________________________________________________________11______1_____1111111_____________________________________________
157 ________________________________________________________________________________________________111111111111____________________________________________________
158 ________________________________________________________________________________________________________________________________________________________________
159 ________________________________________________________________________________________________________________________________________________________________
160 ________________________________________________________________________________________________________________________________________________________________
161 ________________________________________________________________________________________________________________________________________________________________
162 ________________________________________________________________________________________________________________________________________________________________
163 ________________________________________________________________________________________________________________________________________________________________
164 ________________________________________________________________________________________________________________________________________________________________
165 ________________________________________________________________________________________________________________________________________________________________
166 ________________________________________________________________________________________________________________________________________________________________
167 ________________________________________________________________________________________________________________________________________________________________
