    0         10        20        30        40        50        60        70        80        90        100       110       120       130       140       150       
    0123456789012345678901234567890123456789012345678901234567890123456789012345678901234567890123456789012345678901234567890123456789012345678901234567890123456789
0   ________________________________________________________________________________________________________________________________________________________________
1   ________________________________________________________________________________________________________________________________________________________________
2   ________________________________________________________________________________________________________________________________________________________________
3   ________________________________________________________________________________________________________________________________________________________________
4   ________________________________________________________________________________________________________________________________________________________________
5   ________________________________________________________________________________________________________________________________________________________________
6   ________________________________________________________________________________________________________________________________________________________________
7   ________________________________________________________________________________________________________________________________________________________________
8   ________________________________________________________________________________________________________________________________________________________________
9   ________________________________________________________________________________________________________________________________________________________________
10  ________________________________________________________________________________________________________________________________________________________________
11  ________________________________________________________________________________________________________________________________________________________________
12  ________________________________________________________________________________________________________________________________________________________________
13  ________________________________________________________________________________________________________________________________________________________________
14  ________________________________________________________________________________________________________________________________________________________________
15  ________________________________________________________________________________________________________________________________________________________________
16  ________________________________________________________________________________________________________________________________________________________________
17  ________________________________________________________________________________________________________________________________________________________________
18  ________________________________________________________________________________________________________________________________________________________________
19  ________________________________________________________________________________________________________________________________________________________________
20  ________________________________________________________________________________________________________________________________________________________________
21  ________________________________________________________________________________________________________________________________________________________________
22  ________________________________________________________________________________________________________________________________________________________________
23  ________________________________________________________________________________________________________________________________________________________________
24  ________________________________________________________________________________________________________________________________________________________________
25  ________________________________________________________________________________________________________________________________________________________________
26  ________________________________________________________________________________________________________________________________________________________________
27  ________________________________________________________________________________________________________________________________________________________________
28  ________________________________________________________________________________________________________________________________________________________________
29  ________________________________________________________________________________________________________________________________________________________________
30  ________________________________________________________________________________________________________________________________________________________________
31  ________________________________________________________________________________________________________________________________________________________________
32  ________________________________________________________________________________________________________________________________________________________________
33  ________________________________________________________________________________________________________________________________________________________________
34  ________________________________________________________________________________________________________________________________________________________________
35  ________________________________________________________________________________________________________________________________________________________________
36  ________________________________________________________________________________________________________________________________________________________________
37  ________________________________________________________________________________________________________________________________________________________________
38  ________________________________________________________________________________________________________________________________________________________________
39  ________________________________________________________________________________________________________________________________________________________________
40  ________________________________________________________________________________________________________________________________________________________________
41  ________________________________________________________________________________________________________________________________________________________________
42  ________________________________________________________________________________________________________________________________________________________________
43  ________________________________________________________________________________________________________________________________________________________________
44  ________________________________________________________________________________________________________________________________________________________________
45  ________________________________________________________________________________________________________________________________________________________________
46  ________________________________________________________________________________________________________________________________________________________________
47  ________________________________________________________________________________________________________________________________________________________________
48  _111111111111111111111111111111_______________111111111111111111111111111111____________________________________________________________________________________
49  ___________________________1_1_1_______________1___________________________1____________________________________________________________________________________
50  __________________________1_1__1_____________1__1__________________________1____________________________________________________________________________________
51  __________________________1_1__1_____________1__1_________________________1_____________________________________________________________________________________
52  __________________________1_11_1_____________1___1_______________________1______________________________________________________________________________________
53  _________________________1_1_11_______________1__1_______________________1______________________________________________________________________________________
54  _________________________1_1_11_______________1__31______1111111111111111_______________________________________________________________________________________
55  _33______________________1_1_11_______________1__31______3333333333333__________________________________________________________________________________________
56  _33333________33333_____1_131_1________________1_31_333____3333333333333______________333________________________________________________________33333_____33___
57  _33333____33_333333__3331_1311_________________13__13333____3333333333333_____________333333__________3333___333___________333333______________333333333__33333_
58  _333333_3333333333__33331_1311_________________1___133333____3333333333333___________333333333________33333333333__________333333333__________33333333333333333_
59  _3333333333333333___333131_311__________________13__13333_____3333333333333________333333333333_____33333331333333____33__333333333333_______333333333333333333_
60  _333333333333333____333131_311__________________13__13333__3____3333333333333____3333333313333333_33333333313333333_33333333333331333333___33333331111111133333_
61  _333333333333333____333131_31___________________1___31333__33____3333333333333333333333331333333333331333331333333333333333133333133333333333333331333333133333_
62  _33333333333333__3__33311__11____________________1__31333__3333___333331333333333331333331333331333331333331333313333133333133333133331333331333331333333133333_
63  _3333333333333__33__33131__11____________________1___1333__33333____3331333313333331333331333331333331333331333313333133333133333133331333331333331333333133333_
64  _333333333333___33__33131__1_____________________1___3133__333333____331333313333331333331333331333331333331333313333133333133333133331333331333331333333133333_
65  _333333333333__333__33131_11______________________1__3133__33333333___31333313333331333331333331333331333331333313333133333133333133331333331333331333333133333_
66  _33333333333__3333__31313_11______________________1_3_313__33333333___31333313333331333331333331333331333331333313333133333133333133331333331333331333333133333_
67  _3333333333__33333__313131_1_______________________13_313__33333333___31333313333331333331333331333331333331333313333133333133333133331333331333331333333133333_
68  _3333333333__33333__3131311________________________1_3_31__33333333___31333313333331333331333331333331333331333313333133333133333133331333331333331333333133333_
69  _3333333333__33333__13131_1_________________________13_31__33333333___31333313333331333331333331333331333331333313333133333133333133331333331333331333333133333_
70  _3333333333__33333__1311_1___________________________13_1__33333333___31333313333331333331333331333331333331333313333133333133333133331333331333331333333133333_
71  _3333333333__33333__1311_1___________________________13131_33333333___31333313333331333331333331333331333333333313333133333133333133331333331333331333333133333_
72  _3333333333__33333_1311_1_____________________________1_11_33333333___31333313333331333331333331333331111111333313333133333133333133331333331333331333333133333_
73  _3333333333__33333_13111______________________________1_1_133333333___31333313333331333331333331333331333331333313333133333133333133331333331333331333333133333_
74  _3333333333__33333_13111_______________________________1_1133333333___31333313333331333331333331333331333331333313333133333133333133331333331333331333333133333_
75  _3333333333__333331_1_1_________________________________11_13333333___31333313333331333331333331333331333331333313333133333133333133331333331333331333333133333_
76  _3333333333__333331111111111111111111111111111111111111111113333333___31333313333331333331333331333331333331333333333133333133333133331333331333331333333133333_
77  _3333333333__33333__11111111111111111111111111111111111111113333333___31333313333331333331333331333331333331333333333133333133333133331333331111111333333133333_
78  _3333333333__33333__11111111111111111111111111111111111111113333333___31111113333331333333333331333331333331111111111133333333333111111333333333333333333133333_
79  _333___3333__33333_1______________________________________113333333___33333333333331333333333331333331333333333333333333333333333333333333333333333333333333333_
80  ____333_333__333__11_______________________________________11333333___33333333333331333333333331111111333333333333333333333333333333333333333333333333333333333_
81  _3333333_____33_331_________________________________________1333333___33333333333333333333333333333333333333333333333333333333333333333333333333333333333333333_
82  _3333333333__3_331__________________________________________1_33333___33333333333333333333333333333333333333333333333333333333333333333333333333333333333333333_
83  _3333333333___3331___________________________________________1_3333___33333333333333333333333333333333333333333333333333333333333333333333333333333333333333333_
84  _3333333333__3331_____________________________________________13333___33333333333333333333333333333333333333333333333333333333333333333333333333333333333333333_
85  _3333333333__331______________________________________________1_333___3333333333333333333333333333333__333333333333333333_______333333333333333____333333333333_
86  _33333___33__331_______________________________________________1_33___33333333333333333333333333333________333333333333_______________33333___________333333333_
87  _333_____33__31________________________________________________1__3___3333333333333333________333___________________33_________________33_______________3333333_
88  _3________3__1__________________________________________________1_3___33333333____________________________________________________________________________33333_
89  _______1__3__1___________________________________________________1____333333____________________________________________________________________________________
90  ________1_3_1____________________________________________________1____333_______________________________________________________________________________________
91  _________1________________________________________________________1___3_________________________________________________________________________________________
92  11111111111_____________________________________________________________________________________________________________________________________________________
93  ________________________________________________________________________________________________________________________________________________________________
94  ________________________________________________________________________________________________________________________________________________________________
95  ________________________________________________________________________________________________________________________________________________________________
96  ________________________________________________________________________________________________________________________________________________________________
97  ________________________________________________________________________________________________________________________________________________________________
98  ________________________________________________________________________________________________________________________________________________________________
99  ________________________________________________________________________________________________________________________________________________________________
100 ________________________________________________________________________________________________________________________________________________________________
101 ________________________________________________________________________________________________________________________________________________________________
102 ________________________________________________________________________________________________________________________________________________________________
103 ________________________________________________________________________________________________________________________________________________________________
104 ________________________________________________________________________________________________________________________________________________________________
105 ________________________________________________________________________________________________________________________________________________________________
106 ________________________________________________________________________________________________________________________________________________________________
107 ________________________________________________________________________________________________________________________________________________________________
108 ________________________________________________________________________________________________________________________________________________________________
109 ________________________________________________________________________________________________________________________________________________________________
110 ________________________________________________________________________________________________________________________________________________________________
111 ________________________________________________________________________________________________________________________________________________________________
112 ________________________________________________________________________________________________________________________________________________________________
113 ________________________________________________________________________________________________________________________________________________________________
114 ________________________________________________________________________________________________________________________________________________________________
115 ________________________________________________________________________________________________________________________________________________________________
116 ________________________________________________________________________________________________________________________________________________________________
117 ________________________________________________________________________________________________________________________________________________________________
118 ________________________________________________________________________________________________________________________________________________________________
119 ________________________________________________________________________________________________________________________________________________________________
120 ___________________________________________________________________________________1111111111111111111111111111111111111111111111111____________________________
121 ___________________________________________________________________________________1________________11111___11111___11111___11111__1____________________________
122 __________________________________________________________________________________1_________________1___1___1___1___1___1___1___1__1____________________________
123 __________________________________________________________________________________1_________________1___1___1___1___1___1___1___1__1____________________________
124 _________________________________________________________________________________1__________________1___1___1___1___1___1___1___1_11____________________________
125 _________________________________________________________________________________1111111111_________1___1___1___1111111111111_1111______________________________
126 ___________________________________________________________________________________________111______1___1___111111______111111__________________________________
127 ______________________________________________________________________________________________111111111111111___________________________________________________
128 ________________________________________________________________________________________________________________________________________________________________
129 ________________________________________________________________________________________________________________________________________________________________
130 ________________________________________________________________________________________________________________________________________________________________
131 ________________________________________________________________________________________________________________________________________________________________
132 ________________________________________________________________________________________________________________________________________________________________
133 ________________________________________________________________________________________________________________________________________________________________
134 ________________________________________________________________________________________________________________________________________________________________
135 ________________________________________________________________________________________________________________________________________________________________
136 ________________________________________________________________________________________________________________________________________________________________
137 ________________________________________________________________________________________________________________________________________________________________
138 ________________________________________________________________________________________________________________________________________________________________
139 ________________________________________________________________________________________________________________________________________________________________
140 ________________________________________________________________________________________________________________________________________________________________
141 ________________________________________________________________________________________________________________________________________________________________
142 ________________________________________________________________________________________________________________________________________________________________
143 ________________________________________________________________________________________________________________________________________________________________
144 ________________________________________________________________________________________________________________________________________________________________
145 ________________________________________________________________________________________________________________________________________________________________
146 ________________________________________________________________________________________________________________________________________________________________
147 ________________________________________________________________________________________________________________________________________________________________
148 ________________________________________________________________________________________________________________________________________________________________
149 ________________________________________________________________________________________________________________________________________________________________
150 ________________________________________________________________________________________________________________________________________________________________
151 ________________________________________________________________________________________________________________________________________________________________
152 ________________________________________________________________________________________________________________________________________________________________
153 ________________________________________________________________________________________________________________________________________________________________
154 ________________________________________________________________________________________________________________________________________________________________
155 ________________________________________________________________________________________________________________________________________________________________
156 ________________________________________________________________________________________________________________________________________________________________
157 ________________________________________________________________________________________________________________________________________________________________
158 ________________________________________________________________________________________________________________________________________________________________
159 ________________________________________________________________________________________________________________________________________________________________
160 ________________________________________________________________________________________________________________________________________________________________
161 ________________________________________________________________________________________________________________________________________________________________
162 ________________________________________________________________________________________________________________________________________________________________
163 ________________________________________________________________________________________________________________________________________________________________
164 ________________________________________________________________________________________________________________________________________________________________
165 ________________________________________________________________________________________________________________________________________________________________
166 ________________________________________________________________________________________________________________________________________________________________
167 ________________________________________________________________________________________________________________________________________________________________
