    0         10        20        30        40        50        60        70        80        90        100       110       120       130       140       150       
    0123456789012345678901234567890123456789012345678901234567890123456789012345678901234567890123456789012345678901234567890123456789012345678901234567890123456789
0   ________________________________________________________________________________________________________________________________________________________________
1   ________________________________________________________________________________________________________________________________________________________________
2   ________________________________________________________________________________________________________________________________________________________________
3   ________________________________________________________________________________________________________________________________________________________________
4   ________________________________________________________________________________________________________________________________________________________________
5   ________________________________________________________________________________________________________________________________________________________________
6   ________________________________________________________________________________________________________________________________________________________________
7   ________________________________________________________________________________________________________________________________________________________________
8   ________________________________________________________________________________________________________________________________________________________________
9   ________________________________________________________________________________________________________________________________________________________________
10  ________________________________________________________________________________________________________________________________________________________________
11  ________________________________________________________________________________________________________________________________________________________________
12  ________________________________________________________________________________________________________________________________________________________________
13  ________________________________________________________________________________________________________________________________________________________________
14  ________________________________________________________________________________________________________________________________________________________________
15  ________________________________________________________________________________________________________________________________________________________________
16  ________________________________________________________________________________________________________________________________________________________________
17  ________________________________________________________________________________________________________________________________________________________________
18  ________________________________________________________________________________________________________________________________________________________________
19  ________________________________________________________________________________________________________________________________________________________________
20  ________________________________________________________________________________________________________________________________________________________________
21  ________________________________________________________________________________________________________________________________________________________________
22  ________________________________________________________________________________________________________________________________________________________________
23  ________________________________________________________________________________________________________________________________________________________________
24  ________________________________________________________________________________________________________________________________________________________________
25  ________________________________________________________________________________________________________________________________________________________________
26  ________________________________________________________________________________________________________________________________________________________________
27  ________________________________________________________________________________________________________________________________________________________________
28  ________________________________________________________________________________________________________________________________________________________________
29  ________________________________________________________________________________________________________________________________________________________________
30  ________________________________________________________________________________________________________________________________________________________________
31  ________________________________________________________________________________________________________________________________________________________________
32  ________________________________________________________________________________________________________________________________________________________________
33  ________________________________________________________________________________________________________________________________________________________________
34  ________________________________________________________________________________________________________________________________________________________________
35  ________________________________________________________________________________________________________________________________________________________________
36  ________________________________________________________________________________________________________________________________________________________________
37  ________________________________________________________________________________________________________________________________________________________________
38  ________________________________________________________________________________________________________________________________________________________________
39  ________________________________________________________________________________________________________________________________________________________________
40  ________________________________________________________________________________________________________________________________________________________________
41  ________________________________________________________________________________________________________________________________________________________________
42  ________________________________________________________________________________________________________________________________________________________________
43  ________________________________________________________________________________________________________________________________________________________________
44  ________________________________________________________________________________________________________________________________________________________________
45  ________________________________________________________________________________________________________________________________________________________________
46  ________________________________________________________________________________________________________________________________________________________________
47  ________________________________________________________________________________________________________________________________________________________________
48  ________________________________________________________________________________________________________________________________________________________________
49  ________________________________________________________________________________________________________________________________________________________________
50  ________________________________________________________________________________________________________________________________________________________________
51  ________________________________________________________________________________________________________________________________________________________________
52  ________________________________________________________________________________________________________________________________________________________________
53  ___________________________________________________________________________________________________________________________________________________333__________
54  _________________________________________________________________________________________________________________________________________33______33333333333___3
55  ________________________________________________________________________________________________________________________________________33333__33333333333333333
56  _______________________________________________________________________________________________________________________________________3333333333333333333333333
57  ______________________________________________________________________________________________________________________________________33333333333333333333333333
58  _____________________________________________________________________________________________________________________________________333333333333333333333333333
59  _________________________________________________________________________________________________________________33333333333333333333333333333333333333333333333
60  ________________________________________________________________________________________________________33______333333333333333333333333333333333333333333333333
61  ______________________________________________________________________________________________________3333______333333333333333333333333333333333333333333333333
62  _____________________________________________________________________________________________________33333______333333333333333333333333333333333333333333333333
63  ______________________________________________________________________________________________3______33333______333333333333333333333333333333333333333333333333
64  ____________________________________________________________________________________________333______33333______333333333333333333333333333333333333333333333333
65  __________________________________________________________________________________________33333______33333______333333333333333333333333333333333333333333333333
66  _______________________________1111111111________________________________________________333333______33333______333333333333333333333333333333333333333333333333
67  ___________________________1111__________11____________________________________________33333333______33333______333333333333333333333333333333333333333333333333
68  _________________________11________________11__________________________________________3333333_______33333______333333333333333333333333333333333333333333333333
69  ________________________1____________________1________________________________________33333333_______33333______333333333333333333333333333333333333333333333333
70  ________________________1____________________1________________________________________33333333_______33333______333333333333333333333333333333333333333333333333
71  _______________________1111_______________1111_______________________________________333333333_______33333______333333333333333333333333333333333333333333333333
72  ___________________________111111111111111___________________________________________333333333_______33333______333333333333333333333333333333333333333333333333
73  _____________________________________________________________________________________333333333_______33333______333333333333333333333333333333333333333333333333
74  ______________________________________________________________________________________33333333________3333______333333333333333333333333333333333333333333333333
75  ______________________________________________________________________________________33333333________3333______333333333333333333333333333333333333333333333333
76  _______________________________________________________________________________________3333333________3333______333333333333333333333333333333333333333333333333
77  ___________________________________________________________________________________________333________3333______333333333333333333333333333333333333333333333333
78  ______________________________________________________________________________________________________3333______333333333333333333333333333333333333333333333333
79  _________________________________________111111111111111111111111111__________________________________3333______333333333333333333333333333333333333333333333333
80  ___________________________________111111___11111___11111___11111___111111_____________________________333______333333333333333333333333333333333333333333333333
81  _______________________________1111_________1___1___1___1___1___1___11111_111111_____________1111111____33______333333333333333333333333333333333333333333333333
82  _____________________________11_____________1___1___1___1___1___1___1___1_______1111_________11___1_1____3______333333333333333333333333333333333333333333333333
83  ____________________________11111111111111111___11111_111111111111111___1____1111111________1_1___1_1____3______333333333333333333333333333333333333333333333333
84  _____________________________________________111111111____________11111111111______________1__1___1__1__________333333333333333333333333333333333333333333333333
85  __________________________________________________________________________________________1___1___1_1___________333333333333333333333333333333333333333333333333
86  ___________________________________________________________________________________________11_1___11_____3______333333333333333333333333333333333333333333333333
87  _____________________________________________________________________________________________11111_______3______333333333333333333333333333333333333333333333333
88  _________________________________________________________________________________________________________3______333333333333333333333333333333333333333333333333
89  ________________________________________________________________________________________________________33______333333333333333333333333333333333333333333333333
90  ________________________________________________________________________________________________________33______333333333333333333333333333333333333333333333333
91  ________________________________________________________________________________________________________33______333333333333333333333333333333333333333333333333
92  _______________________________________________________________________________________________________333______333333333333333333333333333333333333333333333333
93  _______________________________________________________________________________________________________333______333333333333333333333333333333333333333333333333
94  _______________________________________________________________________________________________________333_______33333333333333333333333333333333333333333333333
95  _______________________________________________________________________________________________________333_______33333333333333333333333333333333333333333333333
96  ______________________________________________________________________________________________________3333_______33333333333333333333333333333333333333333333333
97  ______________________________________________________________________________________________________3333_______33333333333333333333333333333333333333333333333
98  _____________________________________________________________________________________________________33333_______33333333333333333333333333333333333333333333333
99  _____________________________________________________________________________________________________33333_______33333333333333333333333333333333333333333333333
100 ____________________________________________________________________________________________________333333_______33333333333333333333333333333333333333333333333
101 ____________________________________________________________________________________________________333333_______33333333333333333333333333333333333333333333333
102 ____________________________________________________________________________________________________333333_______33333333333333333333333333333333333333333333333
103 ___________________________________________________________________________________________________3333333_______33333333333333333333333333333333333333333333333
104 ___________________________________________________________________________________________________3333333_______33333333333333333333333333333333333333333333333
105 __________________________________________________________________________________________________33333333_______33333333333333333333333333333333333333333333333
106 __________________________________________________________________________________________________33333333_______33333333333333333333333333333333333333333333333
107 ______________________1111111111111111111111______________________________________________________33333333_______33333333333333333333333333333333333333333333333
108 _____________________1___1_______1__________11________11___________________________________________3333333_______33333333333333333333333333333333333333333333333
109 ____________________1____1_______1____________1______1__1__________________________________________333333________33333333333333333333333333333333333333333333333
110 __________________11_____1_______1_____________11____1__1___________________________________________33333________33333333333333333333333333333333333333333333333
111 _________________1_______1_______1_______________11_1____1__________________________________________33333________33333333333333333333333333333333333333333333333
112 ________________11_______1___11111_________________111___1__________________________________________33333________33333333333333333333333333333333333333333333333
113 _______________1_1_______1111___1_111111____________1111111__________________________________________3333________33333333333333333333333333333333333333333333333
114 ______________1__1_____1111_____1_______11111_________1___11_________________________________________3333________33333333333333333333333333333333333333333333333
115 _____________1___1__111___1_____1____________1111______11__1_________________________________________3333________33333333333333333333333333333333333333333333333
116 ___________11____1111_____1_____1________________11111___111_________________________________________3333________33333333333333333333333333333333333333333333333
117 __________1___1111__1_____1_____1_____________________111111_________________________________________3333________33333333333333333333333333333333333333333333333
118 _________1_111___1__1_____1_____1___________________________1111______________________________________333________33333333333333333333333333333333333333333333333
119 ________1111111111111111111111111111111111111111111111111111111111____________________________________333________33333333333333333333333333333333333333333333333
120 ______11______________________________________________________________________________________________333________33333333333333333333333333333333333333333333333
121 _______________________________________________________________________________________________________33________33333333333333333333333333333333333333333333333
122 ________________________________________________________________________________________________________3________33333333333333333333333333333333333333333333333
123 ________________________________________________________________________________________________________3________33333333333333333333333333333333333333333333333
124 _________________________________________________________________________________________________________________33333333333333333333333333333333333333333333333
125 _________________________________________________________________________________________________________________33333333333333333333333333333333333333333333333
126 _________________________________________________________________________________________________________________33333333333333333333333333333333333333333333333
127 _________________________________________________________________________________________________________________33333333333333333333333333333333333333333333333
128 _________________________________________________________________________________________________________1_11111113333333333333333333333333333333333333333333333
129 _________________________________________________________________________________________________________1___1____1333333333333333333333333333333333333333333333
130 _________________________________________________________________________________________________________1111111___133333333333333333333333333333333333333333333
131 ________________________________________________________________________________________________________1_1_1___1_1_33333333333333333333333333333333333333333333
132 _______________________________________________________________________________________________________1__1_1____1___3333333333333333333333333333333333333333333
133 ______________________________________________________________________________________________________1____11___11___3333333333333333333333333333333333333333333
134 _______________________________________________________________________________________________________11__11_11_____3333333333333333333333333333333333333333333
135 _________________________________________________________________________________________________________1__11_______3333333333333333333333333333333333333333333
136 __________________________________________________________________________________________________________11__________333333333333333333333333333333333333333333
137 ______________________________________________________________________________________________________________________333333333333333333333333333333333333333333
138 ______________________________________________________________________________________________________________________333333333333333333333333333333333333333333
139 ______________________________________________________________________________________________________________________333333333333333333333333333333333333333333
140 _____________________________________________________________________________________________________________________3333333333333333333333333333333333333333333
141 _____________________________________________________________________________________________________________________3333333333333333333333333333333333333333333
142 ____________________________________________________________________________________________________________________33333333333333333333333333333333333333333333
143 ____________________________________________________________________________________________________________________33333333333333333333333333333333333333333333
144 ___________________________________________________________________________________________________________________333333333333333333333333333333333333333333333
145 __________________________________________________________________________________________________________________3333333333333333333333333333333333333333333333
146 __________________________________________________________________________________________________________________3333333333333333333333333333333333333333333333
147 _________________________________________________________________________________________________________________33333333333333333333333333333333333333333333333
148 _________________________________________________________________________________________________________________33333333333333333333333333333333333333333333333
149 ________________________________________________________________________________________________________________333333333333333333333333333333333333333333333333
150 _______________________________________________________________________________________________________________3333333333333333333333333333333333333333333333333
151 ______________________________________________________________________________________________________________33333333333333333333333333333333333333333333333333
152 _____________________________________________________________________________________________________________333333333333333333333333333333333333333333333333333
153 ____________________________________________________________________________________________________________3333333333333333333333333333333333333333333333333333
154 ____________________________________________________________________________________________________________3333333333333333333333333333333333333333333333333333
155 ___________________________________________________________________________________________________________33333333333333333333333333333333333333333333333333333
156 ___________________________________________________________________________________________________________33333333333333333333333333333333333333333333333333333
157 __________________________________________________________________________________________________________3333333333333333333333333333333333333333333__333333333
158 ________________________________________________________________________________________________________333333333333333333333333333333333333333333_______3333333
159 __________________________________________________________________________________________________333333333333333333333333333333333333333333333___________333333
160 _________________________________________________________________________________________________3333333333333333333333333333333333333333333_________________333
161 ________________________________________________________________________________________________333333333333333333333333________333333333______________________3
162 ______________________________________________________________________________________________3333333333333333333333_______________333__________________________
163 _____________________________________________________________________________________________333333333333333333333______________________________________________
164 ___________________________________________________________________________________________33333333333333333333_________________________________________________
165 _________________________________________________________________________________________33333333333333333333___________________________________________________
166 _____________________________________________________________________________________3333333333333333333333_____________________________________________________
167 __________________________________________________________________________________3333333333333333333333333_____________________________________________________
