    0         10        20        30        40        50        60        70        80        90        100       110       120       130       140       150       
    0123456789012345678901234567890123456789012345678901234567890123456789012345678901234567890123456789012345678901234567890123456789012345678901234567890123456789
0   ________________________________________________________________________________________________________________________________________________________________
1   ___________________________________________________________________________________________________________________________________________________________1____
2   ___________________________________________________________________________________________________________________________________________________________1____
3   ___________________________________________________________________________________________________________________________________________________________1____
4   ___________________________________________________________________________________________________________________________________________________________1____
5   ___________________________________________________________________________________________________________________________________________________________1____
6   ___________________________________________________________________________________________________________________________________________________________1____
7   ___________________________________________________________________________________________________________________________________________________________1____
8   ___________________________________________________________________________________________________________________________________________________________1____
9   ___________________________________________________________________________________________________________________________________________________________1____
10  ___________________________________________________________________________________________________________________________________________________________1____
11  ___________________________________________________________________________________________________________________________________________________________1____
12  ___________________________________________________________________________________________________________________________________________________________1____
13  ___________________________________________________________________________________________________________________________________________________________1____
14  ___________________________________________________________________________________________________________________________________________________________1____
15  ___________________________________________________________________________________________________________________________________________________________1____
16  ___________________________________________________________________________________________________________________________________________________________1____
17  ___________________________________________________________________________________________________________________________________________________________1____
18  ___________________________________________________________________________________________________________________________________________________________1____
19  ___________________________________________________________________________________________________________________________________________________________1____
20  ___________________________________________________________________________________________________________________________________________________________1____
21  ___________________________________________________________________________________________________________________________________________________________1____
22  ___________________________________________________________________________________________________________________________________________________________1____
23  ___________________________________________________________________________________________________________________________________________________________1____
24  ___________________________________________________________________________________________________________________________________________________________1____
25  ___________________________________________________________________________________________________________________________________________________________1____
26  ___________________________________________________________________________________________________________________________________________________________1____
27  ___________________________________________________________________________________________________________________________________________________________1____
28  ___________________________________________________________________________________________________________________________________________________________1____
29  ___________________________________________________________________________________________________________________________________________________________1____
30  ___________________________________________________________________________________________________________________________________________________________1____
31  ___________________________________________________________________________________________________________________________________________________________1____
32  ___________________________________________________________________________________________________________________________________________________________1____
33  ___________________________________________________________________________________________________________________________________________________________1____
34  ___________________________________________________________________________________________________________________________________________________________1____
35  ___________________________________________________________________________________________________________________________________________________________1____
36  ___________________________________________________________________________________________________________________________________________________________1____
37  ___________________________________________________________________________________________________________________________________________________________1____
38  ___________________________________________________________________________________________________________________________________________________________1____
39  ___________________________________________________________________________________________________________________________________________________________1____
40  _1111111______________________________________________11111111111111111111111111__________________________________________________________________1111111111____
41  1111111111111111111111111111111111111111111111111111111111111111111111111111111111111111111111111111111111111111111111111111111111111111111111111111111111111111
42  ______________________11111111111111________________________________________________________________________1111111111111111111111_________________________1____
43  ___________________________________________________________________________________________________________________________________________________________1____
44  ___________________________________________________________________________________________________________________________________________________________1____
45  ___________________________________________________________________________________________________________________________________________________________1____
46  ___________________________________________________________________________________________________________________________________________________________1____
47  ___________________________________________________________________________________________________________________________________________________________1____
48  ___________________________________________________________________________________________________________________________________________________________1____
49  ___________________________________________________________________________________________________________________________________________________________1____
50  ___________________________________________________________________________________________________________________________________________________________1____
51  ___________________________________________________________________________________________________________________________________________________________1____
52  ___________________________________________________________________________________________________________________________________________________________1____
53  _________________________________________________________________________________________________________________________________________________________111____
54  _______________________________________________________________________________________________________________________________________________________11__1____
55  _____________________________________________________________________________________________________________________________________________________11____1____
56  ___________________________________________________________________________________________________________________________________________________11______1____
57  ________________________________________________________________________________________________________________________________________________111________1____
58  ______________________________________________________________________________________________________________________________________________11___________1____
59  ____________________________________________________________________________________________________________________________________________11_____________1____
60  ____111111111111111____________________________________________________________________________________111111111111111111111111___________111______________1____
61  ____1111111111111_1____________________________________________________________________________________111111111111111111111111______________111___________1____
62  ____11111111111111_____________________________________________________________________________________111111111111111111111111_________________1__________1____
63  _____1111111111111_________________________________________________________________________________________________111111111111__________________1_________1____
64  __________________________________________________________________________________________________________________________________________________1________1____
65  ___________________________________________________________________________________________________________________________________________________1_______1____
66  ____________________________________________________________________________________________________________________________________________________1______1____
67  _____________________________________________________________________________________________________________________________________________________1_____1____
68  ______________________________________________________________________________________________________________________________________________________111111____
69  ___________________________________________________________________________________________________________________________________________________________1____
70  ___________________________________________________________________________________________________________________________________________________________1____
71  ___________________________________________________________________________________________________________________________________________________________1____
72  ___________________________________________________________________________________________________________________________________________________________1____
73  ___________________________________________________________________________________________________________________________________________________________1____
74  ___________________________________________________________________________________________________________________________________________________________1____
75  ___________________________________________________________________________________________________________________________________________________________1____
76  ___________________________________________________________________________________________________________________________________________________________1____
77  ___________________________________________________________________________________________________________________________________________________________1____
78  ___________________________________________________________________________________________________________________________________________________________1____
79  ___________________________________________________________________________________________________________________________________________________________1____
80  ___________________________________________________________________________________________________________________________________________________________1____
81  ___________________________________________________________________________________________________________________________________________________________1____
82  _________________________________________________________________________________________________________________________________111111111111111111111111111____
83  _____________________________________________________________________________________________________________________________1111_________________________11____
84  _______________111111111111111111111111111111111111111111111111111111111111111111111111111111111111________________________11_____________________________11____
85  _______________1__________________________________________________________________________________1________________________111____________________________11____
86  _______________1________________________________________________________________________________111___________________________1111________________________11____
87  _______________11___________1111111111111111111111111111111111111111111111111111111111111_____11__________________________________11111111111111111111111111____
88  _________________11111111111____________________________________________________________1_____1____________________________________________________________1____
89  ________________________________________________________________________________________1____11____________________________________________________________1____
90  ________________________________________________________________________________________1_111______________________________________________________________1____
91  ________________________________________________________________________________________11_________________________________________________________________1____
92  ___________________________________________________________________________________________________________________________________________________________1____
93  ___________________________________________________________________________________________________________________________________________________________1____
94  ___________________________________________________________________________________________________________________________________________________________1____
95  ___________________________________________________________________________________________________________________________________________________________1____
96  ________________________________________________________________________________________________________________________________________________111111111111____
97  ________________________________________________________________________________________________________________________________________________1__________1____
98  _________________________________________________________________________________________________________________________________________________1_________1____
99  _________________________________________________________________________________________________________________________________________________1_________1____
100 _________________________________________________________________________________________________________________________________________________1_________1____
101 __________________________________________________________________________________________________________________________________________________1________1____
102 ___________________________________________________________________________________________________________________________________________________1_______1____
103 ____________________________________________________________________________________________________________________________________________________11111111____
104 ___________________________________________________________________________________________________________________________________________________________1____
105 ___________________________________________________________________________________________________________________________________________________________1____
106 ___________________________________________________________________________________________________________________________________________________________1____
107 ___________________________________________________________________________________________________________________________________________________________1____
108 ___________________________________________________________________________________________________________________________________________________________1____
109 ___________________________________________________________________________________________________________________________________________________________1____
110 ___________________________________________________________________________________________________________________________________________________________1____
111 ___________________________________________________________________________________________________________________________________________________________1____
112 _________________________________________________________________________________3________________________________________________________________________11____
113 _______________________________________________________________________________3333_____________________________________________________________________11_1____
114 _____________________________________________________________________________3333333__________________________________________________________________111__1____
115 ______________________________________________________________________3333333333333333_______________________________________________________________1__1__1____
116 _____________________________________________________________________333333333333333333____________________________________________________________111__1__1____
117 _____________________________________________________________________3333333333333333333__________________________________________________________1__1__1__1____
118 ____________________________________________________________________33333333333333333333________________________________________________________11___1__1__1____
119 ___________________________________________________________________3333333333333333333333_____________________________________________________11_____1__1__1____
120 ___________________________________________________________________3333333333333333333333_111________________________________________________1_______1__1__1____
121 __________________________________________________________________33333333333333333333333_____________________________________________________1______1__1__1____
122 __________________________________________________________________33333333333333333333333_____________________________________________________1______1__1__1____
123 __________________________________________________________________33333333333333333333333______________________________________________________1_____1__1__1____
124 ___________________________________________________________________3333333333333333333333______________________________________________________1_____1__1__1____
125 ___________________________________________________________________3333333333333333333333_______________________________________________________1____1__1__1____
126 ____________________________________________________________________333333333333333333333________________________________________________________1___1__1__1____
127 ______________________________________________________________________333333333333333333__________________________________________________________1__1__1__1____
128 ___________________________________________________________________________3333333333333__________________________________________________________1__1__1__1____
129 _________________________________________________________________________________333333____________________________________________________________1_1__1__1____
130 ___________________________________________________________________________________________________________________________________________________1_1__1__1____
131 ____________________________________________________________________________________________________________________________________________________11__1__1____
132 ____________________________________________________________________________________________________________________________________________________11__1__1____
133 _____________________________________________________________________________________________________________________________________________________1__1__1____
134 _____________________________________________________________________________________________________________________________________________________1__1__1____
135 _____________________________________________________________________________________________________________________________________________________11_1__1____
136 ____________________________________________________________________________________________________________________________________________________11__1__1____
137 __________________________________________________________________________________________________________________________________________________11_1__1__1____
138 ________________________________________________________________________________________________________________________________________________111__1__1__1____
139 _______________________________________________________________________________________________________________________________________________1__1__1__1__1____
140 ___________________________________1111111111111____________________________________________________________________________________________1111__1__1__1__1____
141 ______________________1111111111111_____________1111_______________________________________________________________________________________11__1__1__1__1__1____
142 ____________________11______________________________1111_________________________________________________________________________________11_1__1__1__1__1__1____
143 __________________111___________________________________1111___________________________________________________________________________111__1__1__1__1__1__1____
144 _____________________111111_________11111111111111111111111111________________________________________________________________________1__1__1__1__1__1__1__1____
145 ___________________________111111111_________________________________________________________________________________________________11__1__1__1__1__1__1__1____
146 _____________________________________________________________________________________________________________________________________11__1__1__1__1__1__1__1____
147 ____________________________________________________________________________________________________________________________________1_1__1__1__1__1__1__1__1____
148 ___________________________________________________________________________________________________________________________________11_1__1__1__1__1__1__1__1____
149 __________________________________________________________________________________________________________________________________11111111__1__1__1__1__1__1____
150 _________________________________________________________________________________________________________________________________1111111111_1__1__1__1__1__1____
151 ________________________________________________________________________________________________________________________________1111111111111__1__1__1__1__1____
152 ________________________________________________________________________________________________________________________________1111111111111111__1__1__1__1____
153 ________________________________________________________________________________________________________________________________1111111111111111__1__1__1__1____
154 _______________________________________________________________________________________________________________________________11111111111111111__1__1__1__1____
155 _______________________________________________________________________________________________________________________________11111111111111111__1__1__1__1____
156 _______________________________________________________________________________________________________________________________11111111111111111__1__1__1__1____
157 ______________________________________________________________________________________________________________________________111111111111111111__1__1__1__1____
158 ______________________________________________________________________________________________________________________________111111111111111111__1__1__1__1____
159 ______________________________________________________________________________________________________________________________111111111111111111__1__1__1__1____
160 ______________________________________________________________________________________________________________________________111111111111111111__1__1__1__1____
161 _______________________________________________________________________________________________________________________________111111111111111111_1__1__1__1____
162 _______________________________________________________________________________________________________________________________111111111111111111_1__1__1__1____
163 _______________________________________________________________________________________________________________________________111111111111111111_1__1__1__1____
164 ______________________________________________________________________________________________________________________________111111111111111111111__1__1__1____
165 _____________________________________________________________________________________________________________________________1111111111111111111111__1__1__1____
166 _____________________________________________________________________________________________________________________________1111111111111111111111__1__1__1____
167 _____________________________________________________________________________________________________________________________11111111111111111111111111111111111
