    0         10        20        30        40        50        60        70        80        90        100       110       120       130       140       150       
    0123456789012345678901234567890123456789012345678901234567890123456789012345678901234567890123456789012345678901234567890123456789012345678901234567890123456789
0   ________________________________________________________________________________________________________________________________________________________________
1   ___________________________11111111111111111111111111111111111__________________________________________________________________________________________________
2   ___________________________11111111111111111111111111111111111__________________________________________________________________________________________________
3   ___________________________11111111111111111111111111111111111__________________________________________________________________________________________________
4   ___________________________11111111111111111111111111111111111__________________________________________________________________________________________________
5   ___________________________11111111111111111111111111111111111__________________________________________________________________________________________________
6   ___________________________11111111111111111111111111111111111__________________________________________________________________________________________________
7   ___________________________11111111111111111111111111111111111__________________________________________________________________________________________________
8   ___________________________11111111111111111111111111111111111__________________________________________________________________________________________________
9   ___________________________11111111111111111111111111111111111__________________________________________________________________________________________________
10  ___________________________11111111111111111111111111111111111__________________________________________________________________________________________________
11  ___________________________11111111111111111111111111111111111__________________________________________________________________________________________________
12  ___________________________11111111111111111111111111111111111__________________________________________________________________________________________________
13  ___________________________11111111111111111111111111111111111__________________________________________________________________________________________________
14  ___________________________11111111111111111111111111111111111__________________________________________________________________________________________________
15  ___________________________11111111111111111111111111111111111__________________________________________________________________________________________________
16  ___________________________11111111111111111111111111111111111__________________________________________________________________________________________________
17  ___________________________11111111111111111111111111111111111__________________________________________________________________________________________________
18  ___________________________11111111111111111111111111111111111__________________________________________________________________________________________________
19  ___________________________11111111111111111111111111111111111__________________________________________________________________________________________________
20  ___________________________11111111111111111111111111111111111__________________________________________________________________________________________________
21  ___________________________11111111111111111111111111111111111__________________________________________________________________________________________________
22  ___________________________11111111111111111111111111111111111__________________________________________________________________________________________________
23  ___________________________11111111111111111111111111111111111__________________________________________________________________________________________________
24  ___________________________11111111111111111111111111111111111__________________________________________________________________________________________________
25  ___________________________11111111111111111111111111111111111__________________________________________________________________________________________________
26  ___________________________11111111111111111111111111111111111__________________________________________________________________________________________________
27  ___________________________11111111111111111111111111111111111__________________________________________________________________________________________________
28  ___________________________11111111111111111111111111111111111__________________________________________________________________________________________________
29  ___________________________11111111111111111111111111111111111__________________________________________________________________________________________________
30  ___________________________11111111111111111111111111111111111__________________________________________________________________________________________________
31  ___________________________11111111111111111111111111111111111__________________________________________________________________________________________________
32  ___________________________11111111111111111111111111111111111__________________________________________________________________________________________________
33  ___________________________11111111111111111111111111111111111__________________________________________________________________________________________________
34  ___________________________11111111111111111111111111111111111__________________________________________________________________________________________________
35  ___________________________11111111111111111111111111111111111__________________________________________________________________________________________________
36  ___________________________11111111111111111111111111111111111__________________________________________________________________________________________________
37  ___________________________11111111111111111111111111111111111__________________________________________________________________________________________________
38  ___________________________11111111111111111111111111111111111__________________________________________________________________________________________________
39  ___________________________11111111111111111111111111111111111__________________________________________________________________________________________________
40  ____________________________________________111111111111111111__________________________________________________________________________________________________
41  ________________________________________________________________________________________________________________________________________________________________
42  ________________________________________________________________________________________________________________________________________________________________
43  ________________________________________________________________________________________________________________________________________________________________
44  ________________________________________________________________________________________________________________________________________________________________
45  ________________________________________________________________________________________________________________________________________________________________
46  ________________________________________________________________________________________________________________________________________________________________
47  ________________________________________________________________________________________________________________________________________________________________
48  ________________________________________________________________________________________________________________________________________________________________
49  ________________________________________________________________________________________________________________________________________________________________
50  ________________________________________________________________________________________________________________________________________________________________
51  ________________________________________________________________________________________________________________________________________________________________
52  ________________________________________________________________________________________________________________________________________________________________
53  ________________________________________________________________________________________________________________________________________________________________
54  ________________________________________________________________________________________________________________________________________________________________
55  ________________________________________________________________________________________________________________________________________________________________
56  ________________________________________________________________________________________________________________________________________________________________
57  ________________________________________________________________________________________________________________________________________________________________
58  ________________________________________________________________________________________________________________________________________________________________
59  ________________________________________________________________________________________________________________________________________________________________
60  ________________________________________________________________________________________________________________________________________________________________
61  ________________________________________________________________________________________________________________________________________________________________
62  ________________________________________________________________________________________________________________________________________________________________
63  ________________________________________________________________________________________________________________________________________________________________
64  ________________________________________________________________________________________________________________________________________________________________
65  ________________________________________________________________________________________________________________________________________________________________
66  ________________________________________________________________________________________________________________________________________________________________
67  ________________________________________________________________________________________________________________________________________________________________
68  ______________________________________________________________11111111111111111111111111111111111111111111111111111111111111111111111111111_____________________
69  __________________________________________________________11111_____1_____1_____1______1______1______1_____1_____1______1_____1_____1_____1_____________________
70  _______________________________________________________1111___1_____1_____1_____1______1______1______1_____1_____1______1_____1_____1_____1_____________________
71  _______________________________________________________1111___1_____1_____1_____1______1______1______1_____1_____1______1_____1111111111111_____________________
72  __________________________________________________________1111111___1_____1_____1______1111111111111111111111111111111111111111_________________________________
73  ________________________________________________________________111111____1_111111111111________________________________________________________________________
74  _____________________________________________________________________11111111___________________________________________________________________________________
75  ________________________________________________________________________________________________________________________________________________________________
76  ________________________________________________________________________________________________________________________________________________________________
77  ________________________________________________________________________________________________________________________________________________________________
78  ________________________________________________________________________________________________________________________________________________________________
79  ________________________________________________________________________________________________________________________________________________________________
80  ________________________________________________________________________________________________________________________________________________________________
81  ________________________________________________________________________________________________________________________________________________________________
82  ________________________________________________________________________________________________________________________________________________________________
83  ________________________________________________________________________________________________________________________________________________________________
84  ________________________________________________________________________________________________________________________________________________________________
85  ________________________________________________________________________________________________________________________________________________________________
86  ________________________________________________________________________________________________________________________________________________________________
87  ________________________________________________________________________________________________________________________________________________________________
88  ________________________________________________________________________________________________________________________________________________________________
89  ________________________________________________________________________________________________________________________________________________________________
90  ________________________________________________________________________________________________________________________________________________________________
91  ________________________________________________________________________________________________________________________________________________________________
92  ________________________________________________________________________________________________________________________________________________________________
93  ________________________________________________________________________________________________________________________________________________________________
94  ________________________________________________________________________________________________________________________________________________________________
95  ________________________________________________________________________________________________________________________________________________________________
96  __________________________________________________________________________________________111111111111__________________________________________________________
97  __________________________________________________________________________________________1_1_____1___1_________________________________________________________
98  _________________________________________________________________________________________1__1_____1____1________________________________________________________
99  _________________________________________________________________________________________1__1_____1_____1_______________________________________________________
100 ________________________________________________________________________________________1___1_____1_____1_______________________________________________________
101 ________________________________________________________________________________________11__1_____1____1________________________________________________________
102 __________________________________________________________________________________________1111____1___1_________________________________________________________
103 ______________________________________________________________________________________________111_1_11__________________________________________________________
104 _________________________________________________________________________________________________111____________________________________________________________
105 ________________________________________________________________________________________________________________________________________________________________
106 ________________________________________________________________________________________________________________________________________________________________
107 ________________________________________________________________________________________________________________________________________________________________
108 ________________________________________________________________________________________________________________________________________________________________
109 ________________________________________________________________________________________________________________________________________________________________
110 ________________________________________________________________________________________________________________________________________________________________
111 ________________________________________________________________________________________________________________________________________________________________
112 ________________________________________________________________________________________________________________________________________________________________
113 _____________________________________________111111_____________________________________________________________________________________________________________
114 __________________________________________111_1____111111_______________________________________________________________________________________________________
115 ________________________________________11____1______1___11_____________________________________________________________________________________________________
116 ______________________________________11______1______1____1_____________________________________________________________________________________________________
117 ______________________________________1_______1______1____1_____________________________________________________________________________________________________
118 ______________________________________1_______1______1____1_____________________________________________________________________________________________________
119 ______________________________________111111__1______111111_____________________________________________________________________________________________________
120 ____________________________________________1111111111__________________________________________________________________________________________________________
121 ________________________________________________________________________________________________________________________________________________________________
122 ________________________________________________________________________________________________________________________________________________________________
123 ________________________________________________________________________________________________________________________________________________________________
124 ________________________________________________________________________________________________________________________________________________________________
125 ________________________________________________________________________________________________________________________________________________________________
126 ________________________________________________________________________________________________________________________________________________________________
127 ________________________________________________________________________________________________________________________________________________________________
128 _1111111111_____________________________________________________________________________________________________________________________________________________
129 ____1___1111111111111___________________________________________________________________________________________________________________________________________
130 ____1___1___1___1111111_________________________________________________________________________________________________________________________________________
131 ____1___1___1___1___1__11_______________________________________________________________________________________________________________________________________
132 ____1___1___1___1___1____11_____________________________________________________________________________________________________________________________________
133 ____1___1___1___1___1____1______________________________________________________________________________________________________________________________________
134 ____1___1___1___1___1___1_______________________________________________________________________________________________________________________________________
135 ____1___1___1___1___1___1_______________________________________________________________________________________________________________________________________
136 ____1___1___11111_111111________________________________________________________________________________________________________________________________________
137 ____11111111111111____________________________________________________________________________________________________________________1111111111111111111111111_
138 _111111____________________________________________________________________________________________________________________________111_1___1___1___1___1___1____
139 ________________________________________________________________________________________________________________________________111____1___1___1___1___1___1____
140 ____________________________________________________________________________________________________________________________1111_______1___1___1___1___1___1____
141 _________________________________________________________________________________________________________________________111___________1___1___1___1___1___1____
142 ______________________________________________________________________________________________________________________111______________1___1___1___1___1___1____
143 ____________________________________________________________________________________________________________________1111_______________1___1___1___1___1___1____
144 ________________________________________________________________________________________________________________________111111_________1___1___1___1___1___1____
145 ______________________________________________________________________________________________________________________________111111111111111111111111111111111_
146 ________________________________________________________________________________________________________________________________________________________________
147 ________________________________________________________________________________________________________________________________________________________________
148 ________________________________________________________________________________________________________________________________________________________________
149 ________________________________________________________________________________________________________________________________________________________________
150 ________________________________________________________________________________________________________________________________________________________________
151 ________________________________________________________________________________________________________________________________________________________________
152 ________________________________________________________________________________________________________________________________________________________________
153 ________________________________________________________________________________________________________________________________________________________________
154 ________________________________________________________________________________________________________________________________________________________________
155 ________________________________________________________________________________________________________________________________________________________________
156 ________________________________________________________________________________________________________________________________________________________________
157 ________________________________________________________________________________________________________________________________________________________________
158 ________________________________________________________________________________________________________________________________________________________________
159 ________________________________________________________________________________________________________________________________________________________________
160 ________________________________________________________________________________________________________________________________________________________________
161 ________________________________________________________________________________________________________________________________________________________________
162 ________________________________________________________________________________________________________________________________________________________________
163 ________________________________________________________________________________________________________________________________________________________________
164 ________________________________________________________________________________________________________________________________________________________________
165 ________________________________________________________________________________________________________________________________________________________________
166 ________________________________________________________________________________________________________________________________________________________________
167 ________________________________________________________________________________________________________________________________________________________________
