    0         10        20        30        40        50        60        70        80        90        100       110       120       130       140       150       
    0123456789012345678901234567890123456789012345678901234567890123456789012345678901234567890123456789012345678901234567890123456789012345678901234567890123456789
0   ________________________________________________________________________________________________________________________________________________________________
1   ________________________________________________________________________________________________________________________________________________________________
2   ________________________________________________________________________________________________________________________________________________________________
3   ________________________________________________________________________________________________________________________________________________________________
4   ________________________________________________________________________________________________________________________________________________________________
5   ________________________________________________________________________________________________________________________________________________________________
6   ________________________________________________________________________________________________________________________________________________________________
7   ________________________________________________________________________________________________________________________________________________________________
8   ________________________________________________________________________________________________________________________________________________________________
9   ________________________________________________________________________________________________________________________________________________________________
10  ________________________________________________________________________________________________________________________________________________________________
11  ________________________________________________________________________________________________________________________________________________________________
12  ________________________________________________________________________________________________________________________________________________________________
13  ________________________________________________________________________________________________________________________________________________________________
14  ________________________________________________________________________________________________________________________________________________________________
15  ________________________________________________________________________________________________________________________________________________________________
16  ________________________________________________________________________________________________________________________________________________________________
17  ________________________________________________________________________________________________________________________________________________________________
18  ________________________________________________________________________________________________________________________________________________________________
19  ________________________________________________________________________________________________________________________________________________________________
20  ________________________________________________________________________________________________________________________________________________________________
21  ________________________________________________________________________________________________________________________________________________________________
22  ________________________________________________________________________________________________________________________________________________________________
23  ________________________________________________________________________________________________________________________________________________________________
24  ________________________________________________________________________________________________________________________________________________________________
25  ________________________________________________________________________________________________________________________________________________________________
26  ________________________________________________________________________________________________________________________________________________________________
27  ________________________________________________________________________________________________________________________________________________________________
28  ________________________________________________________________________________________________________________________________________________________________
29  ________________________________________________________________________________________________________________________________________________________________
30  ________________________________________________________________________________________________________________________________________________________________
31  ________________________________________________________________________________________________________________________________________________________________
32  ________________________________________________________________________________________________________________________________________________________________
33  ________________________________________________________________________________________________________________________________________________________________
34  ________________________________________________________________________________________________________________________________________________________________
35  ________________________________________________________________________________________________________________________________________________________________
36  ________________________________________________________________________________________________________________________________________________________________
37  ________________________________________________________________________________________________________________________________________________________________
38  ________________________________________________________________________________________________________________________________________________________________
39  ________________________________________________________________________________________________________________________________________________________________
40  ________________________________________________________________________________________________________________________________________________________________
41  ________________________________________________________________________________________________________________________________________________________________
42  ________________________________________________________________________________________________________________________________________________________________
43  ________________________________________________________________________________________________________________________________________________________________
44  ________________________________________________________________________________________________________________________________________________________________
45  ________________________________________________________________________________________________________________________________________________________________
46  ________________________________________________________________________________________________________________________________________________________________
47  ________________________________________________________________________________________________________________________________________________________________
48  ________________________________________________________________________________________________________________________________________________________________
49  ________________________________________________________________________________________________________________________________________________________________
50  ________________________________________________________________________________________________________________________________________________________________
51  ________________________________________________________________________________________________________________________________________________________________
52  ________________________________________________________________________________________________________________________________________________________________
53  ________________________________________________________________________________________________________________________________________________________________
54  ________________________________________________________________________________________________________________________________________________________________
55  ________________________________________________________________________________________________________________________________________________________________
56  ________________________________________________________________________________________________________________________________________________________________
57  ________________________________________________________________________________________________________________________________________________________________
58  ________________________________________________________________________________________________________________________________________________________________
59  ________________________________________________________________________________________________________________________________________________________________
60  ________________________________________________________________________________________________________________________________________________________________
61  ________________________________________________________________________________________________________________________________________________________________
62  ________________________________________________________________________________________________________________________________________________________________
63  ________________________________________________________________________________________________________________________________________________________________
64  ________________________________________________________________________________________________________________________________________________________________
65  ________________________________________________________________________________________________________________________________________________________________
66  ________________________________________________________________________________________________________________________________________________________________
67  ________________________________________________________________________________________________________________________________________________________________
68  ________________________________________________________________________________________________________________________________________________________________
69  ________________________________________________________________________________________________________________________________________________________________
70  ________________________________________________________________________________________________________________________________________________________________
71  ________________________________________________________________________________________________________________________________________________________________
72  ________________________________________________________________________________________________________3333333333____3_________________________________________
73  _______________________________________________________________________________________________________333333333333_3333________________________________________
74  ______________________________________________________________________________________________________333333333333333333333333__________________________________
75  _____________________________________________________________________________________________________3333333333333333333333333__________________________________
76  _____________________________________________________________________________________________________3333333333333333333333333__________________________________
77  ____________________________________________________________________________________________________33333333333333333333333333__________________________________
78  ____________________________________________________________________________________________________33333333333333333333333333__________________________________
79  ___________________________________________________________________________________________________33333333333333333__3333333___________________________________
80  _________________________________________________________________________________________________333333333333333333______3333___________________________________
81  _________________________________________________________________________________________________333333333333333333________33___________________________________
82  _________________________________________________________________________________________________33333333333333333_________33___________________________________
83  _______________________________________________________________________________________________3333333333333333333__________3___________________________________
84  _______________________________________________________________________________________________3333333333333333333______________________________________________
85  _______________________________________________________________________________________________33333333333333333333_____________________________________________
86  ________________________________________________________211111111_______________________________3333333333333333333_____________________________________________
87  _______________________________________________________2_________1___________________________33_3333333333333333333_____________________________________________
88  _____________________________________________________22___________1__________________________333_33333333333333333______________________________________________
89  ____________________________________________________2______________1__________________________33333333333333333333______________________________________________
90  ___________________________________________________2________________1_________________________3333333333333333333_______________________________________________
91  _________________________________________________22__________________1________________________3333333333333333333_______________________________________________
92  ________________________________________________2_____________________1_____________________3_3333333333333333333_______________________________________________
93  _______________________________________________2_______________________1________________33__33333333333333333333________________________________________________
94  _____________________________________________22_________________________11______________333_33333333333333333333________________________________________________
95  ____________________________________________2_____________________________11____________333333333333333333333333________________________________________________
96  ___________________________________________2________________________________11______33_3333333333333333333333333________________________________________________
97  _________________________________________22___________________________________11___333_3333333333333333333333333________________________________________________
98  ________________________________________2_______________________________________11_33333333333333333333333333333________________________________________________
99  _______________________________________2__________________________________________3333333333333333333333333333_3________________________________________________
100 _____________________________________22__________________________________________33333333333333333333333333333__________________________________________________
101 ___________________________________22___________________________________________33333333333333333333333333333___________________________________________________
102 _______________________________2222____________________________________________333333333333333333333333333333___________________________________________________
103 _____________________________22_______________________________________________3333333333333333333333333333333___________________________________________________
104 ______________________________21_____________________________________________3333333333333333333333333333__33___________________________________________________
105 _______________________________2_____________________________________________333333333333333333333333333________________________________________________________
106 ________________________________1____________________333____________________333333333333333333333333333_________________________________________________________
107 ________________________________1__________________3333333_________________333333333333333333333333333__________________________________________________________
108 _________________________________1________________33333333_________________333333333333333333333333333__________________________________________________________
109 _________________________________1_______________333333333________________33333333333333333333333333333_________________________________________________________
110 _________________________________1_____________33333333333________________33333333333333333333333333333_________________________________________________________
111 __________________________________1___________333333333333________________333333333333333333333333333333________________________________________________________
112 __________________________________1_________33333333333333_______________3333333333333333333333333333333________________________________________________________
113 ___________________________________1_______333333333333333_______________3333333333333333333333333333333________________________________________________________
114 ___________________________________1_______333333333333333_______________3333333333333333333333333333333________________________________________________________
115 ___________________________________1______333333333333333________________3333333333333333333333333333333________________________________________________________
116 ____________________________________1_____333333333333333_______________333333333333333333333333333___33________________________________________________________
117 ____________________________________1____3333333333333333_______________3333333333333333333333333_______________________________________________________________
118 ____________________________________1___33333333333333333_______________3333333333333333333333333_______________________________________________________________
119 _____________________________________1_33333333333333333________________3333333333333333333333333_______________________________________________________________
120 _____________________________________1_3333333333333333_________________33333333333333333333333333______________________________________________________________
121 ______________________________________13333333333333333________________333333333333333333333333333______________________________________________________________
122 ______________________________________1333333333333333_________________333333333333333333333333333______________________________________________________________
123 ______________________________________333333333333333__________________3333333333333333333333333333_____________________________________________________________
124 ______________________________________333333333333333__________________3333333333333333333333333333_____________________________________________________________
125 ______________________________________33333333333333___________________33333333333333333333333333333____________________________________________________________
126 ______________________________________33333333333333___________________33333333333333333333333333333____________________________________________________________
127 _____________________________________33333333333333___________________333333333333333333333333333333____________________________________________________________
128 _____________________________________3333333333333____________________3333333333333333333333333333333___________________________________________________________
129 _____________________________________3333333333333____________________3333333333333333333333333333333___________________________________________________________
130 _____________________________________333333333333_____________________3333333333333333333333333333333___________________________________________________________
131 ____________________________________3333333333333_____________________3333333333333333333333333333333___________________________________________________________
132 ____________________________________333333333333_____________________3333333333333333333333333333__333__________________________________________________________
133 ___________________________________333333333333______________________3333333333333333333333333333____3__________________________________________________________
134 ___________________________________333333333333______________________3333333333333333333333333333_______________________________________________________________
135 __________________________________333333333333_______________________3333333333333333333333333333_______________________________________________________________
136 __________________________________333333333333_______________________3333333333333333333333333333_______________________________________________________________
137 __________________________________33333333333________________________3333333333333333333333333333_______________________________________________________________
138 __________________________________33333333333_______________________33333333333333333333333333333_______________________________________________________________
139 _________________________________33333333333________________________33333333333333333333333333333_______________________________________________________________
140 _________________________________33333333333________________________33333333333333333333333333333_______________________________________________________________
141 _________________________________3333333333________________________3333333333333333333333333333333______________________________________________________________
142 __________________________________332333333_______________________33333333333333333333333333333333______________________________________________________________
143 __________________________________32333333________________________33333333333333333333333333333333______________________________________________________________
144 __________________________________2333___________________________333333333333333333333333333333333______________________________________________________________
145 _________________________________2333____________________________333333333333333333333333333333333______________________________________________________________
146 ________________________________2333____________________________3333333333333333333333333333333333______________________________________________________________
147 ________________________________2333____________________________33333333333333333333333333333333333_____________________________________________________________
148 _______________________________2333_____________________________33333333333333333333333333333333333_____________________________________________________________
149 _______________________________2333_____________________________333333333333333333333333333333333333____________________________________________________________
150 ______________________________2333_____________________________33333333333333333333333333333333333333___________________________________________________________
151 ______________________________2333_____________________________333333333333333333333333333333333333_____________________________________________________________
152 __________________________2222333______________________________333333333333333333333333333333333333_____________________________________________________________
153 _________________________23333333______________________________333333333333333333333333333333333333_____________________________________________________________
154 ________________________23333_________________________________3333333333333333333333333333333333333_____________________________________________________________
155 _______________________2_333__________________________________333333333333333_333333_33333333333333_____________________________________________________________
156 ______________________2__33__________________________________33333333333333____33333__333333333___33____________________________________________________________
157 _____________________2___3___________________________________333333333333______33333____3333333_________________________________________________________________
158 ____________________2________________________________________333333333333_______333_______3333__________________________________________________________________
159 ____________________2_______________________________________333333333333________333__________3__________________________________________________________________
160 ___________________2________________________________________333333333333________333_____________________________________________________________________________
161 __________________2________________________________________3333333333333________________________________________________________________________________________
162 _________________2_________________________________________3333333333333________________________________________________________________________________________
163 ________________2__________________________________________333333333333_________________________________________________________________________________________
164 _______________2__________________________________________3333333333333_________________________________________________________________________________________
165 ______________2___________________________________________3333333333333_________________________________________________________________________________________
166 _____________2____________________________________________3333333333333_________________________________________________________________________________________
167 ________________________________________________________________________________________________________________________________________________________________
