    0         10        20        30        40        50        60        70        80        90        100       110       120       130       140       150       
    0123456789012345678901234567890123456789012345678901234567890123456789012345678901234567890123456789012345678901234567890123456789012345678901234567890123456789
0   ________________________________________________________________________________________________________________________________________________________________
1   ________________________________________________________________________________________________________________________________________________________________
2   ________________________________________________________________________________________________________________________________________________________________
3   ________________________________________________________________________________________________________________________________________________________________
4   ________________________________________________________________________________________________________________________________________________________________
5   ________________________________________________________________________________________________________________________________________________________________
6   ________________________________________________________________________________________________________________________________________________________________
7   ________________________________________________________________________________________________________________________________________________________________
8   ________________________________________________________________________________________________________________________________________________________________
9   ________________________________________________________________________________________________________________________________________________________________
10  ________________________________________________________________________________________________________________________________________________________________
11  ________________________________________________________________________________________________________________________________________________________________
12  ________________________________________________________________________________________________________________________________________________________________
13  ________________________________________________________________________________________________________________________________________________________________
14  ________________________________________________________________________________________________________________________________________________________________
15  ________________________________________________________________________________________________________________________________________________________________
16  ________________________________________________________________________________________________________________________________________________________________
17  ________________________________________________________________________________________________________________________________________________________________
18  ________________________________________________________________________________________________________________________________________________________________
19  ________________________________________________________________________________________________________________________________________________________________
20  ________________________________________________________________________________________________________________________________________________________________
21  ________________________________________________________________________________________________________________________________________________________________
22  ________________________________________________________________________________________________________________________________________________________________
23  ________________________________________________________________________________________________________________________________________________________________
24  ________________________________________________________________________________________________________________________________________________________________
25  ________________________________________________________________________________________________________________________________________________________________
26  ________________________________________________________________________________________________________________________________________________________________
27  ________________________________________________________________________________________________________________________________________________________________
28  ________________________________________________________________________________________________________________________________________________________________
29  ________________________________________________________________________________________________________________________________________________________________
30  ________________________________________________________________________________________________________________________________________________________________
31  ________________________________________________________________________________________________________________________________________________________________
32  ________________________________________________________________________________________________________________________________________________________________
33  ________________________________________________________________________________________________________________________________________________________________
34  ________________________________________________________________________________________________________________________________________________________________
35  ________________________________________________________________________________________________________________________________________________________________
36  ________________________________________________________________________________________________________________________________________________________________
37  ________________________________________________________________________________________________________________________________________________________________
38  ________________________________________________________________________________________________________________________________________________________________
39  ________________________________________________________________________________________________________________________________________________________________
40  ________________________________________________________________________________________________________________________________________________________________
41  ________________________________________________________________________________________________________________________________________________________________
42  ________________________________________________________________________________________________________________________________________________________________
43  ________________________________________________________________________________________________________________________________________________________________
44  ________________________________________________________________________________________________________________________________________________________________
45  ________________________________________________________________________________________________________________________________________________________________
46  ________________________________________________________________________________________________________________________________________________________________
47  ________________________________________________________________________________________________________________________________________________________________
48  ________________________________________________________________________________________________________________________________________________________________
49  ________________________________________________________________________________________________________________________________________________________________
50  ________________________________________________________________________________________________________________________________________________________________
51  ________________________________________________________________________________________________________________________________________________________________
52  ________________________________________________________________________________________________________________________________________________________________
53  ________________________________________________________________________________________________________________________________________________________________
54  ________________________________________________________________________________________________________________________________________________________________
55  ________________________________________________________________________________________________________________________________________________________________
56  ________________________________________________________________________________________________________________________________________________________________
57  ________________________________________________________________________________________________________________________________________________________________
58  ________________________________________________________________________________________________________________________________________________________________
59  ________________________________________________________________________________________________________________________________________________________________
60  ________________________________________________________________________________________________________________________________________________________________
61  ________________________________________________________________________________________________________________________________________________________________
62  ________________________________________________________________________________________________________________________________________________________________
63  ________________________________________________________________________________________________________________________________________________________________
64  ________________________________________________________________________________________________________________________________________________________________
65  ________________________________________________________________________________________________________________________________________________________________
66  ________________________________________________________________________________________________________________________________________________________________
67  ________________________________________________________________________________________________________________________________________________________________
68  ________________________________________________________________________________________________________________________________________________________________
69  ________________________________________________________________________________________________________________________________________________________________
70  _1111111111111111111111111111111111111111111111111111111111_____________________________________________________________________________________________________
71  __________________________________________________________1_____________________________________________________________________________________________________
72  __________________________________________________________1_____________________________________________________________________________________________________
73  __________________________________________________________1_____________________________________________________________________________________________________
74  __________________________________________________________1_____________________________________________________________________________________________________
75  __________________________________________________________1_____________________________________________________________________________________________________
76  __________________________________________________________1_____________________________________________________________________________________________________
77  __________________________________________________________1_____________________________________________________________________________________________________
78  __________________________________________________________1_____________________________________________________________________________________________________
79  __________________________________________________________1_____________________________________________________________________________________________________
80  __________________________________________________________1_____________________________________________________________________________________________________
81  __________________________________________________________1_____________________________________________________________________________________________________
82  __________________________________________________________1_____________________________________________________________________________________________________
83  __________________________________________________________1_____________________________________________________________________________________________________
84  __________________________________________________________1_____________________________________________________________________________________________________
85  __________________________________________________________1_____________________________________________________________________________________________________
86  __________________________________________________________1_____________________________________________________________________________________________________
87  __________________________________________________________1_____________________________________________________________________________________________________
88  __________________________________________________________1_____________________________________________________________________________________________________
89  __________________________________________________________1_____________________________________________________________________________________________________
90  __________________________________________________________1_____________________________________________________________________________________________________
91  __________________________________________________________1_____________________________________________________________________________________________________
92  __________________________________________________________1_____________________________________________________________________________________________________
93  __________________________________________________________1_____________________________________________________________________________________________________
94  __________________________________________________________1_____________________________________________________________________________________________________
95  __________________________________________________________1_____________________________________________________________________________________________________
96  __________________________________________________________1_____________________________________________________________________________________________________
97  __________________________________________________________1_____________________________________________________________________________________________________
98  __________________________________________________________1_____________________________________________________________________________________________________
99  __________________________________________________________1_____________________________________________________________________________________________________
100 __________________________________________________________1_____________________________________________________________________________________________________
101 __________________________________________________________1_____________________________________________________________________________________________________
102 __________________________________________________________1_____________________________________________________________________________________________________
103 __________________________________________________________1_____________________________________________________________________________________________________
104 __________________________________________________________1_____________________________________________________________________________________________________
105 __________________________________________________________1_____________________________________________________________________________________________________
106 __________________________________________________________1_____________________________________________________________________________________________________
107 __________________________________________________________1_____________________________________________________________________________________________________
108 __________________________________________________________1_____________________________________________________________________________________________________
109 __________________________________________________________1_____________________________________________________________________________________________________
110 __________________________________________________________1_____________________________________________________________________________________________________
111 __________________________________________________________1_____________________________________________________________________________________________________
112 __________________________________________________________1_____________________________________________________________________________________________________
113 __________________________________________________________1_____________________________________________________________________________________________________
114 __________________________________________________________1_____________________________________________________________________________________________________
115 __________________________________________________________1_____________________________________________________________________________________________________
116 __________________________________________________________1_____________________________________________________________________________________________________
117 ____1___11111___11111_____________________________________1_____________________________________________________________________________________________________
118 1___1___1___1___1___1_____________________________________1_____________________________________________________________________________________________________
119 1___1___1___1___1___1_____________________________________1_____________________________________________________________________________________________________
120 1___1___1___1___1___1______________________________________11________________________________________________________________________111111111__________________
121 1___1___1___1___1___1_______________________________________111111111111111111111111111______________________________________________1_______1__________________
122 1___1___1___1___1___1_________________________________________11________________________1____________________________________________1_______1__________________
123 1___1___1___1___1___1___________________________________________1_______________________133__________________________________________1_______1__________________
124 1___1___1___1___1___1____________________________________________11_____________________13333________________________________________1_______1__________________
125 1___1___1___1___1___1______________________________________________1____________________1333333______________________________________1______11__________________
126 1___1___1___1___1___1_______________________________________________11__________________133333333____________________________________1____11____________________
127 1___1___1___1___1___1_________________________________________________1_________________1333333333____________________________________1111______________________
128 1___1___1___1___1___1__________________________________________________11_______________133333333333____________________________________________________________
129 1___1___1___1___1___1____________________________________________________1______________1333333333333___________________________________________________________
130 1___1___1___1___1___1_____________________________________________________1_____________133333333333333_________________________________________________________
131 1___1___1___1___1___1______________________________________________________11___________1_33333333333___________________________________________________________
132 1___1___1___1___1___1________________________________________________________1__________1_3333333333____________________________________________________________
133 1___1___1___1___1___1_________________________________________________________11________1_3333333333____________________________________________________________
134 1___1___1___1___1___1___________________________________________________________1_______1_333333333_____________________________________________________________
135 1___1___1___1___1___1____________________________________________________________11_____1_333333333_____________________________________________________________
136 1___1___1___1___1___1______________________________________________________________1____1_33333333______________________________________________________________
137 1___1___1___1___1___1_______________________________________________________________11__1_3333333_______________________________________________________________
138 1___1___1___1___1___1_________________________________________________________________1_1_3333333_______________________________________________________________
139 1___1___1___1___1___1__________________________________________________________________11_3333333_______________________________________________________________
140 1___1___1___1___1___1___________________________________________________________________1133333_________________________________________________________________
141 1___1___1___1___1___1___________________________________________________________________1133333_________________________________________________________________
142 1___1___1___1___1___1_____________________________________________________________________1333________________________________22222222__________________________
143 1___1___1___1___1___1_____________________________________________________________________1_33_______________________________2________22________________________
144 111111__1___1___1___1_____________________________________1111111111______________________1__3______________________________2___________2_______________________
145 ____11111___1___1___1___________________________________11__________11111111_______1111111_________________________________2_____________2______________________
146 _______1___111111111111111111111111111111111111111111111____________________1____11_______________________________________2_______________2_____________________
147 ________111__________________________________________________________________1111________________________________________3333______________2____________________
148 ________________________________________________________________________________________________________________________3333333_____________2___________________
149 _______________________________________________________________________________________________________________________3333333333____________2__________________
150 ______________________________________________________________________________________________________________________333333333333____________2_________________
151 ______________________________________________________________________________________________________________________33333333333333__________2_________________
152 _____________________________________________________________________________________________________________________33333333333333333_________2______________11
153 _____________________________________________________________________________________________________________________3333333333333333333_______2___________111_1
154 ____________________________________________________________________________________________________________________333333333333333333333______2_________11____1
155 ___________________________________________________________________________________________________________________3_3333333333333333333333____2______111______1
156 ___________________________________________________________________________________________________________________33333333333333333333333333112111111_________1
157 __________________________________________________________________________________________________________________3_333333333333333333333333333______1_________1
158 __________________________________________________________________________________________________________________3333333333333333333333333333333____1_________1
159 ___________________________________________________________________________________________________________________3333333333333333333333333333333____1________1
160 __________________3333333333333333333333333333333333333333333333333333333333333333333333333333333333333333333333333333333333333333333333333333333333___1_______1
161 333333333333333333333333333333333333333333333333333333333333333333333333333333333333333333333333333333333333333333333333333333333333333333333333333333_1_______1
162 _33333333333333333333333333333333333333333333333333333333333333333333333333333333333333333333333333333333333333333333333333333333333333333333333333333331______1
163 _33333333333333333333333333333333333333333333333333333333333333333333333333333333333333333333333333333333333333333333333333333333333333333333333333333331______1
164 _3333333333333333333333333333333333333333333333333333333333333333333333333333333333333333333333333333333333333333333333333333333333333333333333333333333313____1
165 _333333333333333333333333333333333333333333333333333333333333333333333333333333333333333333333333333333333333333333333333333333333333333333333333333333333133__1
166 _333333333333333333333333333333333333333333333333333333333333333333333333333333333333333333333333333333333333333333333333333333333333333333333333333333333133331
167 __________________3_________________________________________________________________________________________________________________________3______________11111
