    0         10        20        30        40        50        60        70        80        90        100       110       120       130       140       150       
    0123456789012345678901234567890123456789012345678901234567890123456789012345678901234567890123456789012345678901234567890123456789012345678901234567890123456789
0   ________________________________________________________________________________________________________________________________________________________________
1   ________________________________________________________________________________________________________________________________________________________________
2   ________________________________________________________________________________________________________________________________________________________________
3   ________________________________________________________________________________________________________________________________________________________________
4   ________________________________________________________________________________________________________________________________________________________________
5   ________________________________________________________________________________________________________________________________________________________________
6   ________________________________________________________________________________________________________________________________________________________________
7   ________________________________________________________________________________________________________________________________________________________________
8   ________________________________________________________________________________________________________________________________________________________________
9   ________________________________________________________________________________________________________________________________________________________________
10  ________________________________________________________________________________________________________________________________________________________________
11  ________________________________________________________________________________________________________________________________________________________________
12  ________________________________________________________________________________________________________________________________________________________________
13  ________________________________________________________________________________________________________________________________________________________________
14  ________________________________________________________________________________________________________________________________________________________________
15  ________________________________________________________________________________________________________________________________________________________________
16  ________________________________________________________________________________________________________________________________________________________________
17  ________________________________________________________________________________________________________________________________________________________________
18  ________________________________________________________________________________________________________________________________________________________________
19  ________________________________________________________________________________________________________________________________________________________________
20  ________________________________________________________________________________________________________________________________________________________________
21  ________________________________________________________________________________________________________________________________________________________________
22  ________________________________________________________________________________________________________________________________________________________________
23  ________________________________________________________________________________________________________________________________________________________________
24  ________________________________________________________________________________________________________________________________________________________________
25  ________________________________________________________________________________________________________________________________________________________________
26  ________________________________________________________________________________________________________________________________________________________________
27  ________________________________________________________________________________________________________________________________________________________________
28  ________________________________________________________________________________________________________________________________________________________________
29  ________________________________________________________________________________________________________________________________________________________________
30  ________________________________________________________________________________________________________________________________________________________________
31  ________________________________________________________________________________________________________________________________________________________________
32  ________________________________________________________________________________________________________________________________________________________________
33  ________________________________________________________________________________________________________________________________________________________________
34  ________________________________________________________________________________________________________________________________________________________________
35  ________________________________________________________________________________________________________________________________________________________________
36  ________________________________________________________________________________________________________________________________________________________________
37  ________________________________________________________________________________________________________________________________________________________________
38  ________________________________________________________________________________________________________________________________________________________________
39  ________________________________________________________________________________________________________________________________________________________________
40  ________________________________________________________________________________________________________________________________________________________________
41  ________________________________________________________________________________________________________________________________________________________________
42  ________________________________________________________________________________________________________________________________________________________________
43  ________________________________________________________________________________________________________________________________________________________________
44  _______________________________________________________________________________________________________________________________________________________________3
45  ___________________________________________________________________________________________________________________________________________________________333_3
46  ____________________________________________________________________________________________________________________________________________________333333333333
47  _________________________________________________________________________________________________________________________________________________333333333333333
48  ________________________________________________________________________________________________________________________________________________3333333333333333
49  _______________________________________________________________________________________________________________________________________________33333333333333333
50  ______________________________________________________________________________________________________________________________________________333333333333333333
51  _____________________________________________________________________________________________________________________________________________3333333333333333333
52  ____________________________________________________________________________________________________________________________________________33333333333333333333
53  ___________________________________________________________________________________________________________________________________________333333333333333333333
54  __________________________________________________________________________________________________________________________________________3333333333333333333333
55  _________________________________________________________________________________________________________________________________________33333333333333333333333
56  _______________________________________________________________________________________________________________________________________3333333333333333333333333
57  ________________________________________________________________________________________________________________________________33333333333333333333333333333333
58  _____________________________________________________________________________________________________________________________33333333333333333333333333333333333
59  ___________________________________________________________________________________________________________________________3333333333333333333333333333333333333
60  __________________________________________________________________________________________________________________________33333333333333333333333333333333333333
61  ________________________________________________________________________________________________________________________3333333333333333333333333333333333333333
62  _______________________________________________________________________________________________________________________33333333333333333333333333333333333333333
63  ______________________________________________________________________________________________________________________333333333333333333333333333333333333333333
64  _____________________________________________________________________________________________________________________3333333333333333333333333333333333333333333
65  ____________________________________________________________________________________________________________________33333333333333333333333333333333333333333333
66  __________________________________________________________________________________________________________________3333333333333333333333333333333333333333333333
67  __________________________________________________________111111111111111111111111111111111______________________33333333333333333333333333333333333333333333333
68  __________________________________________________________1_______1___111111___1__________1_____________________333333333333333333333333333333333333333333333333
69  __________________________________________________________1_______1111______11111111_______1__________________33333333333333333333333333333333333333333333333333
70  _________________________________________________________1______111____________1____11111__1________________3333333333333333333333333333333333333333333333333333
71  _________________________________________________________1___111__1____________1_________1__1___________33333333333333333333333333333333333333333333333333333333
72  _________________________________________________________1_11_____1____________1__________1_1________33333333333333333333333333333333333333333333333333333333333
73  _________________________________________________________1_1______1____________1___________11______3333333333333333333333333333333333333333333333333333333333333
74  ________________________________________________________1_1_______1____________1_____________1___333333333333333333333333333333333333333333333333333333333333333
75  ________________________________________________________1_1_______1____________1_____________1133333333333333333333333333333333333333333333333333333333333333333
76  ________________________________________________________11________1____________1_____________1333333333333333333333333333333333333333333333333333333333333333333
77  ________________________________________________________11________1____________1____________31333333333333333333333333333333333333333333333333333333333333333333
78  _______________________________________________________11_________1____________1___________313333333333333333333333333333333333333333333333333333333333333333333
79  _______________________________________________________11_________1____________1_________33133333333333333333333333333333333333333333333333333333333333333333333
80  _______________________________________________________11_________1____________1________333133333333333333333333333333333333333333333333333333333333333333333333
81  _________________________________________________________1111_____1____________1_______3331333333333333333333333333333333333333333333333333333333333333333333333
82  _____________________________________________________________1111_1____________1_____333313333333333333333333333333333333333333333333333333333333333333333333333
83  _________________________________________________________________111___________1____3333313333333333333333333333333333333333333333333333333333333333333333333333
84  ______________________1111__________________________________________11_________1__33333113333333333333333333333333333333333333333333333333333333_333333333333333
85  _________________1111111111___________________________________________111______13331111333333333333333333333333333333333333333333333333333333333_333333333333333
86  ______________11111___1___1______________________________________________11___311113333333333333333333333333333333333333333333333333333333333333_333333333333333
87  _____________11___1___1___11_______________________________________________1111333333333333333333333333333333333333333333333333333333333333333333_33333333333333
88  __________111_1___1___1___11_______________________________________________3333333333333333333333333333333333333333333333333333333333333333333333__3333333333333
89  ______11111___1___1___1___1_1_____________________________________________33333333333333333333333333333333333333333333333333333333333333333333333___333333333333
90  ______11__1___1___1___1___1_1____________________________________________333333333333333333333333333333333333333333333333333333333333333333333333___333333333333
91  ____111___1___1___1___1___1__1__________________________________________3333333333333333333333333333333333333333333333333333333333333333333333333____33333333333
92  __11__1___1___1___1___1___1__1_________________________________________33333333333333333333333333333333333333333333333333333333333333333333333333____33333333333
93  __1___1___1___1___1___1___1___1_______________________________________3333333333333333333333333333333333333333333333333333333333333333333333333333____3333333333
94  __1___1___1___1___1___1___1___1_____________________________________333333333333333333333333333333333333333333333333333333333333333333333333333333____3333333333
95  __1___1___1___1___1___1___1___11__________________________________33333333333333333333333333333333333333333333333333333333333333333333333333333333____3333333333
96  __1___1___1___1___1___1___1___1_1________________________________333333333333333333333333333333333333333333333333333333333333333333333333333333333____3333333333
97  __1___1___1___1___1___1___1___1_1______________________________333333333333333333333333333333333333333333333333333333333333333333333333333333333333___3333333333
98  __1___1___1___1___1___1___1___1__1____________________________3333333333333333333333333333333333333333333333333333333333333333333333333333333333333____333333333
99  __1___1___1___1___1___1___1___1__1____________________________3333333333333333333333333333333333333333333333333333333333333333333333_333333333333333___333333333
100 __11__1___1___1___1___1___1___1___1_________________________3_3333333333333333333333333333333333333333333333333333333333333333333333_333333333333333___333333333
101 __11__1___1___1___1___1___1___1___1________________________33_33333333333333333333333333333333333333333333333333333333333333333333333___3333333333333__333333333
102 __1_1_1___1___1___1___1___1___1____1_______________________33_333333333333333333333333333333333333333333333333333333333333333333333333___3333333333333_333333333
103 __1_1_1___1___1___1___1___1___1____1______________________333_33333333333333333333333333333333333333333333333333333333333333333333333____3333333333333_333333333
104 __1__11___1___1___1___1___1___1_____1_____________________333_33333333333333333333333333333333333333333333333333333333333333333333333_____333333333333_333333333
105 __11_11___1___1___1___1___1___1_____1_____________________333_333333333333333333333333333333333333333333333333333333333333333333333333_____333333333333_33333333
106 ___11_1___1___1___1___1___1___1_____11____________________333_333333333333333333333333333333333333333333333333333333333333333333333333_____333333333333_33333333
107 ___1_11___1___1___1___1___1___1_1111______________________333_3333333333333333333333333333333333333333333333333333333333333333333333333_____33333333333_33333333
108 ____1_11__1___1___1___1___111111__________________________333_3333333333333333333333333333333333333333333333333333333333333333333333333_____33333333333_33333333
109 ____1__1__11111___1___1__1111_____________________________333_33333333333333333333333333333333333333333333333333333333333333333333333333_____33333333333_3333333
110 _____11111111111111111111_________________________________333_33333333333333333333333333333333333333333333333333333333333333333333333333_____33333333333_3333333
111 __________________________________________________________333_333333333333333333333333333333333333333333333333333333333333333333333333333____33333333333_3333333
112 ___________________________________________________________33_333333333333333333333333333333333333333333333333333333333333333333333333333_____3333333333_3333333
113 ___________________________________________________________33_3333333333333333333333333333333333333333333333333333333333333333333333333333____33333333333_333333
114 ___________________________________________________________33_33333333333333333333333333333333333333333_3333333333333333333333333333333333____33333333333_333333
115 ____________________________________________________________3_33333333333333333333333333333333333333333_33333333333333333333333333333333333__3333333333333_33333
116 ____________________________________________________________3_33333333333333333333333333333333333333333_333333333333333333333333333333333333__333333333333_33333
117 ______________________________________________________________33333333333333333333333333333333333333333_3333333333333333333333333333333333333_333333333333_33333
118 ______________________________________________________________3333333333333333333333333333333333333333_333333333333333333333333333333333333333_33333333333_33333
119 ______________________________________________________________3333333333333333333333333333333_33333333_333333333333333333333333333333333333333_33333333333_33333
120 ______________________________________________________________333333333333333333333333333_333_33333333_3333333333333333333333333333333333333333_33333333333_3333
121 _______________________________________________________________33333333333333333333333333_333_33333333_3333333333333333333333333333333333333333_33333333333_33_3
122 _______________________________________________________________333333333333333333333333333_333_3333333_33333333333333333333333333333333333333333_3333333333_33_3
123 ________________________________________________________________33333333333333333333333333_333_333333_333333333333333333333333333333333333333333_3333333333_33_3
124 ________________________________________________________________333333333333333333333333333_33_333333_3333333333333333333333333__3333333333333333_333333333_33_3
125 _________________________________________________________________33333333333333333333333333_33_333333_3333333333333__33333333______33333333333333_333333333_33_3
126 _________________________________________________________________333333333333333333333333333_3_333333_3333333333______33333________33333333333333_3333_33333_3_3
127 __________________________________________________________________33333333333333333333333333_33_33333_33333333________3333________333333333333333_3333_33333_3_3
128 ___________________________________________________________________3333333333333333333333333_33_3333_333333333_________33_________3333333333333333_3333_3333_3_3
129 _____________________________________________________________________333333333333333333333333_3_3333_3333333333_______3333_________333333333333333_3333_3333_3_3
130 ______________________________________________________________________33333333333333333333333_3_3333_33333333333333___33333________333333333333333_3333_3333_3_3
131 _______________________________________________________________________3333333333333333333333_33_333_333333333333333333333333_______333333333333333_3_3_3333_3_3
132 ________________________________________________________________________33333333333333333_333_33_33_333333333333333333333333333__333333333333333333_3_33_333_3_3
133 ________________________________________________________________________33333333333333333_3333_3_33_3333__33333333333333333333333333333333333333333_33_3_333_3_3
134 _________________________________________________________________________33333333333333333_333_33__3333_33333333333333333333333333333333333333333333_3_3_333__33
135 ____________________________________________________________________________33333333333333_333_33__3333_33333333333333333333333333333333333333333333_3_3_333__33
136 _______________________________________________________________________________333333333333_333_33_3333_33333333333333333333333333333333333333333333_3_3_333__33
137 ________________________________________________________________________________33333333333_333_3__333_333333333333333333333333333333333333333333333_33__333__33
138 __________________________________________________________________________________333333333_333_3__333_3333333333333333333333333333333333333333333333_3__333__33
139 _________________________________________________________________________________________333_33_3__333_3333333333333333__3333333333333333333333333333_3__3333_33
140 ___________________________________________________________________________________________3_333__333_333333333333333_____333333333333333333333333333_33_3333_33
141 _____________________________________________________________________________________________333__333_33333333333333______33333333333333333_3333333333_3__333_33
142 _______________________________________________________________________________________________3__33_333333333333333_____33333333333333_____3333333333_3__333_33
143 __________________________________________________________________________________________________33_33333333333333______333333333333______3333_333333_3__333_33
144 __________________________________________________________________________________________________3_33333333333333________333333333________33333_33333_33_333_33
145 ____________________________________________________________________________________________________333333333333333________3333333333_______3333_333333_3_333_33
146 ____________________________________________________________________________________________________33333333333333333____33333333333333_____33333_333_3_3_333_33
147 ____________________________________________________________________________________________________3333333333333333333333333333333333333____3333_333_3_3__33_33
148 _____________________________________________________________________________________________________33333333333333333333_3333333333333333___33333_33_3_3__33_33
149 ______________________________________________________________________________________________________3333333333333333333_333333333333333333333333_333_3___33_33
150 _______________________________________________________________________________________________________3333333333333333333_333333333333333333333333_33_3__3_3_33
151 _______________________________________________________________________________________________________3333333333333333333_33333_333333333333333333_33_3__3_3_33
152 ________________________________________________________________________________________________________333333333333333_333_3333__33333333333333333_33_3__3_3_33
153 ________________________________________________________________________________________________________3333333333333333_33_333_33_33333333333333333_3_33_3_3_33
154 _________________________________________________________________________________________________________333333333333333_33_333_33333333333333333333_3_33_33_3_3
155 _________________________________________________________________________________________________________3333333333333333_33_3_333333333333333333333_33_3__3_3_3
156 __________________________________________________________________________________________________________333333333333333_33__3333333333333333333333_33_3__3_3_3
157 ___________________________________________________________________________________________________________333333333333333_33_33333333333333333333333_3_33_33__3
158 _____________________________________________________________________________________________________________3333333333333_3_333333333333333333333333_3_33_33__3
159 ______________________________________________________________________________________________________________3333333333333__333333333333333333333333_3_33__3__3
160 ________________________________________________________________________________________________________________33333333333__3333333333333333333333333_________3
161 __________________________________________________________________________________________________________________333333333__333333333333333____________________
162 ________________________________________________________________________________________________________________________________________________________________
163 _________________________________________________________________________________________________________________________________3333___________________________
164 ________________________________________________________________________________________________________________________________________________________________
165 ________________________________________________________________________________________________________________________________________________________________
166 ________________________________________________________________________________________________________________________________________________________________
167 ________________________________________________________________________________________________________________________________________________________________
