    0         10        20        30        40        50        60        70        80        90        100       110       120       130       140       150       
    0123456789012345678901234567890123456789012345678901234567890123456789012345678901234567890123456789012345678901234567890123456789012345678901234567890123456789
0   ________________________________________________________________________________________________________________________________________________________________
1   ______________________________________________________________________________________1____________1______________________________________________1_____________
2   ___________________________________________________________________________________________________1______________________________________________1_____________
3   ___________________________________________________________________________________________________1______________________________________________1_____________
4   ___________________________________________________________________________________________________1______________________________________________1_____________
5   ___________________________________________________________________________________________________1______________________________________________1_____________
6   ___________________________________________________________________________________________________1______________________________________________1_____________
7   ___________________________________________________________________________________________________1______________________________________________1_____________
8   ___________________________________________________________________________________________________1______________________________________________1_____________
9   ___________________________________________________________________________________________________1______________________________________________1_____________
10  ___________________________________________________________________________________________________1______________________________________________1_____________
11  ___________________________________________________________________________________________________1______________________________________________1_____________
12  ___________________________________________________________________________________________________1______________________________________________1_____________
13  ___________________________________________________________________________________________________1______________________________________________1_____________
14  ___________________________________________________________________________________________________1______________________________________________1_____________
15  ___________________________________________________________________________________________________1______________________________________________1_____________
16  ___________________________________________________________________________________________________1______________________________________________1_____________
17  ___________________________________________________________________________________________________1______________________________________________1_____________
18  ___________________________________________________________________________________________________1______________________________________________1_____________
19  ___________________________________________________________________________________________________1______________________________________________1_____________
20  ___________________________________________________________________________________________________1______________________________________________1_____________
21  ___________________________________________________________________________________________________1______________________________________________1_____________
22  ___________________________________________________________________________________________________1______________________________________________1_____________
23  ___________________________________________________________________________________________________1______________________________________________1_____________
24  ___________________________________________________________________________________________________1______________________________________________1_____________
25  ___________________________________________________________________________________________________1______________________________________________1_____________
26  ___________________________________________________________________________________________________1______________________________________________1_____________
27  ___________________________________________________________________________________________________1______________________________________________1_____________
28  ___________________________________________________________________________________________________1______________________________________________1_____________
29  ___________________________________________________________________________________________________1______________________________________________1_____________
30  ___________________________________________________________________________________________________1______________________________________________1_____________
31  ___________________________________________________________________________________________________1______________________________________________1_____________
32  ______________________________________________________________________________________1____________1______________________________________________1_____________
33  ______________________________________________________________________________________1____________1______________________________________________1_____________
34  ______________________________________________________________________________________1____________1______________________________________________1_____________
35  _______________________________________________________________1______________________1____________1______________________________________________1_____________
36  _______________________________________________________________1_____________________1_____________1______________________________________________1_____________
37  _______________________________________________________________1_____________________1_____________1____________________________________________111_____________
38  _______________________________________________________________1_____________________1_____________1________________________________________1111________________
39  _______________________________________________________________11111111111111111111111_____________1____________________________________1111____________________
40  ___________________________________________________________________________________________________1________________________________1111________________________
41  ___________________________________________________________________________________________________111111111111111111111111111111111____________________________
42  _____________________________________________________________________________________________________________________________________________________________33_
43  _________________________________________________________________________________________________________________________________________________________333333_
44  _111111111111_____________________________________________________________________________________________________________________________________3333333333333_
45  ____1___1___111___________________________________________________________________________________________________________________________________3333333333333_
46  ____1___1___1__11________________________________________________________________________________________________________________________________33333333333333_
47  ____11111___1_1111______________________________________________________________________________________________________________________________333333333333333_
48  _1111111111111_______________________________________________________________1111111111111111111_______________________________________________3333333333333333_
49  ____________________________________________________________________________1___________________1______________________________________________3333333333333333_
50  ___________________________________________________________________________1____________________1_____________________________________________33333333333333333_
51  ___________________________________________________________________________1_____________________1___________________________________________333333333333333333_
52  ___________________________________________________________________________1_____________________1__________________________________________3333333333333333333_
53  ___________________________________________________________________________1_____________________1__________________________________________3333333333333333333_
54  ____________________________________________________________________________11___________________1_________________________________________33333333333333333333_
55  ______________________________________________________________________________111______11111111111________________________________________333333333333333333333_
56  _________________________________________________________________________________111111__________________________________________________3333333333333333333333_
57  _______________________________________________________________________________________________________________________________________333333333333333333333333_
58  _______________________________________111111111111111________________________________________________________________________________3333333333333333333333333_
59  _______________________________11111111_______________1111_______________________________________________________________________333333333333333333333333333333_
60  ___________________________1111___________________________11___________________________________1111111111111111111111111_________333333333333333333333333333333_
61  ____________________________1____________________________11____________________________________1_______________________1_________333333333333333333333333333333_
62  ____________________________1___________________________1______________________________________1_______________________1_________333333333333333333333333333333_
63  _____________________________1_________________________1_______________________________________1____________111111111111__________33333333333333333333333333333_
64  _____________________________1_________11111111111___11_________________________________________111111111111_3333_________________3333333__3333333333333333333__
65  ______________________________11111111111111111111111_______________________________________________333333333333__________________33333______3333_33333333333___
66  _33333333________________________________________________________________________3333333333333333333333333333333__________________33333______33____333333333____
67  _333333333333____________________________________________________33333333333333333333333333333333333333333333333__________________33333______3______3333333_____
68  _33333333333333333333___________________________________33333333333333333333333333333333333333333333333333333333__________________33333______3______333333______
69  _3333333333333333333333333333333333________________333333333333333333333333333333333333333333333333333333333333___________________3333_______________33_33______
70  _333333333333333333333333333333333333_____3___33333333333333333333333333333333333333333333333333333333333333333___________________333___________________________
71  _333333333333333333333333333333333333_____333333333333333333333333333333333333333333333333333333333333333333333___________________33____________________________
72  _333333333333333333333333333333333333______33333333333333333333333333333333333333333333333333333333333333333333___________________3_____________________________
73  _333333333333333333333333333333333333______3333333333333333333333333333333333333333333333333333333333333333333__________________________________________________
74  _333333333333333333333333333333333333______3333333333333333333333333333333333333333333333333333333333333333333__________________________________________________
75  _333333333333333333333333333333333333______3333333333333333333333333333333333333333333333333333333333333333333__________________________________________________
76  _333333333333333333333333333333333333______333333333333333333333333333333333333333333333333333333333333333333___________________________________________________
77  _3333333333333333333333_3333333333333______333333333333333333333333333333333333333333333333333333333333333333___________________________________________________
78  _333333333333333333333___333333333333______33333333333333_333333333333333333333333333333333333333333333333333___________________________________________________
79  _333333333333333333333___333333333333______33333333333333__33333333333333333333333333333333333333333333333333___________________________________________________
80  _33333333333333333333_____33333333333_______33333333333____3333333333333333333333333333333333333333333333333____________________________________________________
81  _33333333333333333333_____33333333333_______3333333333______333333333333333333333333333333333333333333333333__________________________________1111111___________
82  _3333333333333333333_______33333333333______3333333333______333333333333333333333333333333333333333333333333_____________________1111111111111__1111111_________
83  _33333333333333333331111___33333333333______333_333333_______3333333333333333333333333333333333333333333333________111111111111111__1___1___1___1___1__11_______
84  _3333333333333333331____11133333333333______33_33333331111111133333333333333333333333333333333333333333333311111111__1___1___1___1__1___1___1___1___1___11______
85  _33333333333333333331_____133333333333______3_333333331______1333333333333333333333333333333333333333333331__1___1___1___1___1___1__1___1___111111111111________
86  _3333333333333333333311111133333333333______3_33333333311____1333333333333333333333333333333333333333333331__1___1___1___1___1___1111111111111111_______________
87  _3333333333333333333333333333333333333______3_333333333331111133333333333333333333333333333333333333333331___1___1___1___1___1____1_____________________________
88  _3333333333333333333333333333333333333______3_333333333333333333333333333333333333333333333333333333333___1__1___1___1___1___1____1_____________________________
89  _3333333333333333333333333333333333333______3_333333333333333333333333333333333333333333333333333333333____1_1___1___1___1___1____1_____________________________
90  _3333333333333333333333333333333333333_______333_333333333333333333333333333333333333333333333333333333_____11___1___1___1___1____1_____________________________
91  _3333333333333333333333333333333333333_______333_333333333333333333333333333333333333333333333333333333______1___1___1___1___1__11______________________________
92  _3333333333333333333333333333333333333_______33_3333333333333333333333333333333333333333333333333333333_______1__1___1___1___111________________________________
93  _3333333333333333333333333333333333333_______33_333_3333333333333333333333333333333333333333333333333333_______1_1___1___1__11_________111______________________
94  _3333333333333333333333333333333333333_______3_333_333333333333333333333333333333333333333333333333333333_______11___1___111_________111__11____________________
95  _3333333333333333333333333333333333333_______3_333_3333333333333333333333333333333333333333333333333333333_______111111111_________11__1___1____________________
96  _333333333333333333333333333333333333_________333_333333333333333333333333333333333333333333333333333333333________________________1___1___1____________________
97  _33333333333333333333333333333_33_333_________33_33333333333333333333333333333333333333333333333333333333333________________________11_1_11_____________________
98  _33333333333333333333333333333_33_333_________3_3333333333333333333333333333333333333333333333333333333333333_________________________111_______________________
99  _333333333333333333333333333333_3_333_________3_3333_333333333333333333333333333333333333333333333333333333333__________________________________________________
100 _333333333333333333333333333333_33_33__________33333_33333333333333333333333333333333333333333333333333333333333________________________________________________
101 _333333333333333333333333333333_33_33__________3333_3333333333333333333333333333333333333333333333333333333333333_______________________________________________
102 __333333333333333333333333333333_3_33__________3333_333333333333333333333333333333333333333333333333333333333333333333__________________________________________
103 ____333333333333333333333333_333_3_33__________3333_3333333333333333333333333333333333333333333333333333333333333333333_________________________________________
104 _______3333333333333333333333_33_3_3___________333_333333333333333333333333333333333333333333333333333333333333333333333________________________________________
105 __________33333333333333333333_33__3___________3_3_333333333333333333333333333333333333333333333333333333333333333333333________________________________________
106 ____________33333333333333333__________________3_3_3333333333333333333333333333333333333333333333333333333333333333333333_______________________________________
107 ______________________________________111111_______33333333333333333333333333333333333333333333333333333333333333333333333______________________________________
108 ________________________________1_1111______111__________________________________________3333333333333333333333333333333333_____________________________________
109 _________________________________1____________1____________________________________________333333333333333333333333333333333____________________________________
110 __________________________________111_____1111__________________________________________________333333333333333333333333333333__________________________________
111 _____________________________________11111________________________________________________________33333333333333333333333333333_________________________________
112 ____________________________________________________________________________________________________3333333333333333333333333333________________________________
113 ______________________________________________________________________________________________________33_33333333333333333333333________________________________
114 _________________________________________________________________________________________________________3333333333333333333_3333_______________________________
115 _________________________________________________________________________________________________________3333333333333333333___333______________________________
116 __________________________________________________________________________________________________________33333_333333333333___333______________________________
117 ___________________________________________________________________________________________________________3333_333333333333___333______________________________
118 ___________________________________________________________________________________________________________333_333333333333_____333_____________________________
119 ____________________________________________________________________________________________________________33_333333333333_____333_____________________________
120 _____________________________________________________________________________________________________________3_333333333311111111333____________________________
121 ______________________________________________________________________________________________________________33333333333311____1333____________________________
122 ______________________________________________________________________________________________________________33333333333333111113333___________________________
123 _______________________________________________________________________________________________________________3_333333333333___33333___________________________
124 ________________________________________________________________________________________________________________33333333333333__333333__________________________
125 ________________________________________________________________________________________________________________3333333333333333333333__________________________
126 _________________________________________________________________________________________________________________33333333333_3333333333_________________________
127 _________________________________________________________________________________________________________________3333333333___333333333_________________________
128 __________________________________________________________________________________________________________________333333333____333333333________________________
129 __________________________________________________________________________________________________________________33333333_____333333333________________________
130 ___________________________________________________________________________________________________________________3333333______333333333_______________________
131 _________________________________________________________________________________________________________1111______3333333__11__3333333333______________________
132 ___________________________________________________________________________________________________________________333333111__113333333333______________________
133 ___________________________________________________________________________________________________________________33333311__11333333333333_____________________
134 ____________________________________________________________________________________________________________________333333311333333333333333____________________
135 ____________________________________________________________________________________________________________________333333333333333333333333____________________
136 ____________________________________________________________________________________________________________________3333333333333333333333333___________________
137 _____________________________________________________________________________________________________________________333333333333333333333333___________________
138 _____________________________________________________________________________________________________________________3333333333333333333333333__________________
139 _____________________________________________________________________________________________________________________3333333333333333333333333__________________
140 ______________________________________________________________________________________________________________________333333333333333333333333__________________
141 ______________________________________________________________________________________________________________________333333333333333333333333__________________
142 ______________________________________________________________________________________________________________________333333333333333333333333__________________
143 ______________________________________________________________________________________________________________________3333333333333333333333333_________________
144 ______________________________________________________________________________________________________________________3333333333333333333333333_________________
145 ______________________________________________________________________________________________________________________3333333333333333333333333_________________
146 ______________________________________________________________________________________________________________________3333333333333333333333333_________________
147 ______________________________________________________________________________________________________________________3333333333333333333333333_________________
148 _____________________________________________________________________________________________________________________33333333333333333333333333_________________
149 _____________________________________________________________________________________________________________________33333333333333333333333333_________________
150 _____________________________________________________________________________________________________________________33333333333333333333333333_________________
151 _____________________________________________________________________________________________________________________33333333333333333333333333_________________
152 _____________________________________________________________________________________________________________________33333333333333333333333333_________________
153 _____________________________________________________________________________________________________________________33333333333333333333333333_________________
154 _____________________________________________________________________________________________________________________33333333333333333333333333_________________
155 _____________________________________________________________________________________________________________________33333333333333333333333333_________________
156 _____________________________________________________________________________________________________________________3333333333333333333333333__________________
157 _____________________________________________________________________________________________________________________3333333333333333333333333__________________
158 _____________________________________________________________________________________________________________________3333333333333333333333333__________________
159 _____________________________________________________________________________________________________________________3333333333333333333333333__________________
160 _____________________________________________________________________________________________________________________333333333333333333333333___________________
161 _____________________________________________________________________________________________________________________333333333333333333333333___________________
162 _____________________________________________________________________________________________________________________333333333333333333333333___________________
163 _____________________________________________________________________________________________________________________333333333333333333333333___________________
164 _____________________________________________________________________________________________________________________3333333333333333333333333__________________
165 _____________________________________________________________________________________________________________________3333333333333333333333333__________________
166 _____________________________________________________________________________________________________________________3333333333333333333333333__________________
167 ________________________________________________________________________________________________________________________________________________________________
