    0         10        20        30        40        50        60        70        80        90        100       110       120       130       140       150       
    0123456789012345678901234567890123456789012345678901234567890123456789012345678901234567890123456789012345678901234567890123456789012345678901234567890123456789
0   _____________________1________1_________1___________1____________________________________________________________1___1__________________________________________
1   _____________________1________1_________1___________1___________________________________________________________11___1__________________________________________
2   _____________________1________1_________1___________1___________________________________________________________11___1__________________________________________
3   _____________________1________1_________1___________1___________________________________________________________11___1__________________________________________
4   _____________________1________1_________1___________1__________________________________________________________1_1___1__________________________________________
5   _____________________1________1_________1___________1__________________________________________________________111___1__________________________________________
6   _____________________1________1_________1___________1__________________________________________________________11____1__________________________________________
7   _____________________1________1_________1___________1__________________________________________________________11____1__________________________________________
8   _____________________1________1_________1___________1__________________________________________________________11____1__________________________________________
9   _____________________1________1_________1___________1__________________________________________________________11____1__________________________________________
10  _____________________1________1_________1___________1__________________________________________________________11____1__________________________________________
11  _____________________1________1_________1___________1__________________________________________________________11____1__________________________________________
12  _____________________1________1_________1__________1___________________________________________________________11____1__________________________________________
13  _____________________1________1_________1__________1___________________________________________________________11____1__________________________________________
14  _____________________1________1_________1_________1____________________________________________________________111___1__________________________________________
15  _____________________1________1_________1_________1_____________________________________________________________11___1__________________________________________
16  _____________________1________1_________1________1______________________________________________________________11___1__________________________________________
17  _____________________1________1_________1________1______________________________________________________________11___1__________________________________________
18  _____________________1________1_________1_______1_______________________________________________________________11___1__________________________________________
19  _____________________1________1_________1_______1_______________________________________________________________11___1__________________________________________
20  _____________________1________1_________1______1________________________________________________________________11___1__________________________________________
21  _____________________1________1_________1______1________________________________________________________________11___1__________________________________________
22  _____________________1________1_________1______1________________________________________________________________11___1___1______________________________________
23  _____________________1________1_________1_____11________________________________________________________________11___1__________________________________________
24  _____________________1________1_________1_____1_________________________________________________________________11___1__________________________________________
25  _____________________1________1_________1_____1________________________________________________________________11____1__________________________________________
26  _____________________1________1_________1_____1________________________________________________________________11____1__________________________________________
27  _____________________1________1_________1_____1________________________________________________________________11____1__________________________________________
28  _____________________1________1_________1____11________________________________________________________________11____1__________________________________________
29  _____________________1________1_________1____1_________________________________________________________________11____1__________________________________________
30  _____________________1________1_________1____1________________________________________________________________1_1____1__________________________________________
31  _____________________1________1_________1____1________________________________________________________________111____1__________________________________________
32  _____________________1________1_________1___1_________________________________________________________________11_____1__________________________________________
33  _____________________1________1_________1__1__________________________________________________________________11_____1__________________________________________
34  _____________________1________1_________1_1___________________________________________________________________11_____1__________________________________________
35  _____________________1________1_________11____________________________________________________________________11_____1__________________________________________
36  _____________________1________1_________11____________________________________________________________________11_____1__________________________________________
37  _____________________1________1_________11____________________________________________________________________11_____1__________________________________________
38  _____________________1________1_________11____________________________________________________________________11_____1__________________________________________
39  _____________________1________1_________11____________________________________________________________________11_____1__________________________________________
40  _____________________1________1_________11___________________________________________________________________1_1_____1____________________1_____________________
41  _____________________1________1_________11___________________________________________________________________111_____1____1111111111______1_______1_____________
42  _____________________1________1_________1_1__________________________________________________________________11______1____1________1______1_______1_____________
43  _____________________1________1_________1_1__________________________________________________________________1_1_____1____1________1______1_______1_____________
44  _____________________1________1_________1_1___________________________________________________________________11_____1____1________1______1_______1_____________
45  _____________________1________1_________1__1__________________________________________________________________11_____1____1________1______1_______1_____________
46  _____________________1________1_________1__1__________________________________________________________________11_____1____1________1______1_______1_____________
47  _____________________1________1_________1__1__________________________________________________________________1_1____1____1________1______1_______1_____________
48  _____________________1________1_________1___1__________________________________________________________________11____1____1________1______1_______1_____________
49  _____________________1________1_________1___1__________________________________________________________________11____1____1________1______1_______1_____________
50  _____________________1________1_________1___1__________________________________________________________________11____1____1________1______1_______1_____________
51  _____________________1________1_________1___1__________________________________________________________________1_1___1____1________1______1_______1_____________
52  _____________________1________1_________1____1__________________________________________________________________11___1____1________1______1_______1_____________
53  _____________________1________1_________1____1__________________________________________________________________11___1____1________1______1_______1_____________
54  _____________________1________1_________1____1___________________________________________________________________11__1____1________1______1_______1_____________
55  _____________________1________1_________1_____1__________________________________________________________________11__1____1________1______1_______1_____________
56  _____________________1________1_________1_____1__________________________________________________________________11__1____1________1______1_______1_____________
57  _____________________1________1_________1_____1__________________________________________________________________11__1____1________1______1_______1_____________
58  _____________________1________1_________1_____1__________________________________________________________________1_1_1____1________1______1_______1_____________
59  _____________________1________1_________1____1____________________________________________________________________11_1____1________1______1_______1_____________
60  _____________________1________1_________1____1____________________________________________________________________11_1____1________1______1_______1_____________
61  _____________________1________1_________1____1____________________________________________________________________11_1____1________1______1_______1_____________
62  _____________________1________1_________1____1____________________________________________________________________1_11____1________1______1_______1_____________
63  _____________________1________1_________1____1_____________________________________________________________________111____1________1______1_______1_____________
64  _____________________1________1_________1___1______________________________________________________________________1_1____1________1______1_______1_____________
65  _____________________1________1_________1___1______________________________________________________________________111____1________1______1_______1_____________
66  _____________________1________1_________1___1_______________________________________________________________________11____1________1______1_______1_____________
67  _____________________1________1_________1__1________________________________________________________________________11____1________1______1_______1_____________
68  _____________________1________1_________1__1_________________________________________________________________________1____1________1______1_______1_____________
69  _____________________1________1_________1_1___________________________________________________________________________1___1________1______1_______1_____________
70  _____________________1________1_________1_1___________________________________________________________________________1___1________1______1_______1_____________
71  _____________________1________1_________11_____________________________________________________________________________1__1________1______1_______1_____________
72  _____________________1________1_________11_____________________________________________________________________________1__1________1______1_______1_____________
73  _____________________1________1_________1_______________________________________________________________________________1_1________1______1_______1_____________
74  _____________________1________1_________1_______________________________________________________________________________1_1________1______1_______1_____________
75  _____________________1________1________1_________________________________________________________________________________11________1______1_______1_____________
76  _____________________1________1________1_________________________________________________________________________________11________1______1_______1_____________
77  _____________________1________1_______1___________________________________________________________________________________1________1______1_______1_____________
78  _____________________1________1_______1____________________________________________________________________________________1_______1______1_______1_____________
79  _____________________1________1______1_____________________________________________________________________________________1_______1______1_______1_____________
80  _____________________1________1______1______________________________________________________________________________________1______1______1_______1_____________
81  _____________________1________1_____1________________________________________________________________________________________1_____1______1_______1_____________
82  _____________________1________1_____1________________________________________________________________________________________1_____1______1_______1_____________
83  _____________________1________1____1__________________________________________________________________________________________1____1______1_______1_____________
84  _____________________1________1____1__________________________________________________________________________________________1____1______1_______1_____________
85  _____________________1________1___1___________________________________________________________________________________________1____1______1_______1_____________
86  _____________________1________1___1___________________________________________________________________________________________1____1______1_______1_____________
87  _____________________1________1___1___________________________________________________________________________________________1____1______1_______1_____________
88  _____________________1________1___1____________________________________________________________________________________________1___1______1_______1_____________
89  _____________________1________1___1____________________________________________________________________________________________1___1______1_______1_____________
90  _____________________1________1___1____________________________________________________________________________________________1___1______1_______1_____________
91  _____________________1________1___1____________________________________________________________________________________________1___1______1_______1_____________
92  _____________________1________1__11____________________________________________________________________________________________1___1______1_______1_____________
93  _____________________1________1__1______________________________________________________________________________________________1__1______1_______1_____________
94  _____________________1________1__1______________________________________________________________________________________________1__1______1_______1_____________
95  _____________________1________1__1______________________________________________________________________________________________1__1______1_______1_____________
96  _____________________1________1__1______________________________________________________________________________________________1__1______1_______1_____________
97  _____________________1________1__1______________________________________________________________________________________________1__1______1_______1_____________
98  _1111111111111111111111111111111111111_________________________________________________________________________________________1___1______1_______1_____________
99  _____________________________________1_________________________________________________________________________________________1___1______1_______1_____________
100 _____________________________________1_________________________________________________________________________________________1___1______1_______1_____________
101 _____________________________________1________________________________________________________________________________________1____1______1_______1_____________
102 _____________________________________1_______________________________________________________________________________________1_____1______1_______1_____________
103 _____________________________________1_______________________________________________________________________________________1_____1______1_______1_____________
104 _____________________________________1______________________________________________________________________________________11_____1______1_______1_____________
105 _____________________________________1_____________________________________________________________________________________1_1_____1______1_______1_____________
106 _____________________________________1____________________________________________________________________________________1__1_____1______1_______1_____________
107 ____________________________________1____________________________________________________________________________________1___1_____1______1_______1_____________
108 ___________________________________1____________________________________________________________________________________1____1_____1______1_______1_____________
109 __________________________________1____________________________________________________________________________________1_____1_____1______1_______1_____________
110 _________________________________1_____________________________________________________________________________________1_____1_____1______1_______1_____________
111 _______________________________11_____________________________________________________________________________________1______1_____1______1_______1_____________
112 ______________________________1_______________________________________________________________________________________1______1_____1______1_______1_____________
113 _____________________________1_______________________________________________________________________________________11______1_____1______1_______1_____________
114 ____________________________1________________________________________________________________________________________11______1_____1______1_______1_____________
115 ___________________________1_________________________________________________________________________________________11______1_____1______1_______1_____________
116 _11111111111111111111111111__________________________________________________________________________________________11______1_____1______1_______1_____________
117 _____________________________________________________________________________________________________________________11______1_____1______1_______1_____________
118 _____________________________________________________________________________________________________________________11______1_____1______1_______1_____________
119 _____________________________________________________________________________________________________________________11______1_____1______1_______1_____________
120 _____________________________________________________________________________________________________________________11______1_____1______1_______1_____________
121 _____________________________________________________________________________________________________________________11______1_____1______1_______1_____________
122 _____________________________________________________________________________________________________________________11______1_____1______1_______1_____________
123 _____________________________________________________________________________________________________________________11______1_____1______1_______1_____________
124 _____________________________________________________________________________________________________________________11______1_____1______1_______1_____________
125 _____________________________________________________________________________________________________________________11______1_____1______1_______1_____________
126 _____________________________________________________________________________________________________________________11______1_____1______1_______1_____________
127 _____________________________________________________________________________________________________________________11______1_____1______1_______1_____________
128 ____________________________________________________________________________________________________________________1_1______1_____1______1_______1_____________
129 ____________________________________________________________________________________________________________________111______1_____1______1_______1_____________
130 _1111111111111111111111111111111111111111___________________________________________________________________________11_______1_____1______1_______1_____________
131 _____________________1______1_______11______________________________________________________________________________11_______1_____1______1_______1_____________
132 _____________________1______1_______11______________________________________________________________________________11_______1_____1______1_______1_____________
133 _____________________1______1_______11______________________________________________________________________________11_______1_____1______1_______1_____________
134 _____________________1______1_______11______________________________________________________________________________11_______1_____1______1_______1_____________
135 _____________________1______1_______11______________________________________________________________________________11_______1_____1______1_______1_____________
136 _____________________1______1_______11______________________________________________________________________________11_______1_____1______1_______1_____________
137 _____________________1______1_______1_1_____________________________________________________________________________11_______1_____1______1_______1_____________
138 _____________________1______1_______1_1_____________________________________________________________________________11_______1_____1______1_______1_____________
139 _____________________1______1_______1_1_____________________________________________________________________________11_______1_____1______1_______1_____________
140 _____________________1______1_______1__1____________________________________________________________________________11_______1_____1______1_______1_____________
141 _____________________1______1_______1___1_____________________________________________1111111______________________1_1_______1_____1______1_______1_____________
142 _____________________1______1_______1____1____________________________________________1_____1_____________________1__1_______1_____1______1_______1_____________
143 _____________________1______1_______1_____1___________________________________________1111111____________________1___1_______1_____1______1_______1_____________
144 _____________________1______1_______1______11______1111111111111________________________________________________1____1_______1_____1______1_______1_____________
145 _____________________1______1_______1______1_1_____1___________1________________________________________________1____1_______1_____1______1_______1_____________
146 _____________________1______1_______1______1__1____1111111111111_______________________________________________1_____1_______1_____1______1_______1_____________
147 _____________________1______1_______1______1__1________________________________________________________________1_____1_______1_____1______1_______1_____________
148 _____________________1______1_______1______1___1______________________________________________________________1______1_______1_____1______1_______1_____________
149 _____________________1______1_______1______1___1______________________________________________________________1______1_______1_____1______1_______1_____________
150 _____________________1______1_______1______1____11___________________________________________________________11______1_______1_____1______1_______1_____________
151 _____________________1______1_______1______1______1__________________________________________________________11______1_______1_____1______1_______1_____________
152 _____________________1______1_______1______1______11_________________________________________________________11______1_______1_____1______1_______1_____________
153 _____________________1______1_______1______1______1_11_______________________________________________________11______1_______1_____1______1_______1_____________
154 _____________________1______1_______1______1______1___11____________________________________________________1_1______1_______1_____1______1_______1_____________
155 _____________________1______1_______1______1______1_____111111111___________________________________________1_1______1_______1_____1______1_______1_____________
156 _____________________1______1_______1______1______1________1_____1_________________________________________1__1______1_______1_____1______1_______1_____________
157 _____________________1______1_______1______1______1________1_____1_____________________1111111_____________1__1______1_______1_____1______1_______1_____________
158 _____________________1______1_______1______1______1________1______1_111111_________1111_1_____111_________1___1______1_______1_____1______1_______1_____________
159 _____________________1______1_______1______1______1________1______11______111___111_____1_______111____111____1______1_______1_____1______1_______1_____________
160 _____________________1______1_______1______1______1________1_______1______1__111_1______1_______1__11111______1______1_______1_____1______1_______1_____________
161 _____________________1______1_______1______1______1________1_______1______1______1______1_______1______1______1______1_______1_____1______1_______1_____________
162 _____________________1______1_______1______1______1________1_______1______1______1______1_______1______1______1______1_______1_____1______1_______1_____________
163 _____________________1______1_______1______1______1________1_______1______1______1______1_______1______1______1______1_______1_____1______1_______1_____________
164 _____________________1______1_______1______1______1________1_______1______1______1______1_______1______1______1______1_______1_____1______1_______1_____________
165 _____________________1______1_______1______1______1________1_______1______1______1______1_______1______1______1______1_______1_____1______1_______1_____________
166 _____________________1______1_______1______1______1________1_______1______1______1______1_______1______1______1______1_______1_____1______1_______1_____________
167 _____________________1______1_______1______1______1________1_______1______1______1______1_______1______1______1______1_______1_____1______1_______1_____________
