    0         10        20        30        40        50        60        70        80        90        100       110       120       130       140       150       
    0123456789012345678901234567890123456789012345678901234567890123456789012345678901234567890123456789012345678901234567890123456789012345678901234567890123456789
0   ________________________________________________________________________________________________________________________________________________________________
1   ___1___1___11111________________________________________________________________________________________________________________________________________________
2   ___1___1___1___1________________________________________________________________________________________________________________________________________________
3   ___1___1___1___1________________________________________________________________________________________________________________________________________________
4   ___1___1___1___1________________________________________________________________________________________________________________________________________________
5   ___1___1___1___1________________________________________________________________________________________________________________________________________________
6   ___1___1___1___1________________________________________________________________________________________________________________________________________________
7   ___1___1___1___1________________________________________________________________________________________________________________________________________________
8   ___1___1___1___1________________________________________________________________________________________________________________________________________________
9   ___1___1___1___1________________________________________________________________________________________________________________________________________________
10  ___1___1___1___1________________________________________________________________________________________________________________________________________________
11  ___1___1___1___1________________________________________________________________________________________________________________________________________________
12  ___1___1___1___1________________________________________________________________________________________________________________________________________________
13  ___1___1___1___1________________________________________________________________________________________________________________________________________________
14  ___1___1___1___1________________________________________________________________________________________________________________________________________________
15  ___1___1___1___1________________________________________________________________________________________________________________________________________________
16  ___1___1___1___1________________________________________________________________________________________________________________________________________________
17  ___1___1___1___1________________________________________________________________________________________________________________________________________________
18  ___1___1___1___1________________________________________________________________________________________________________________________________________________
19  ___1___1___1___1________________________________________________________________________________________________________________________________________________
20  ___1___1___1___1________________________________________________________________________________________________________________________________________________
21  ___1___1___1___1________________________________________________________________________________________________________________________________________________
22  ___1___1___1___1________________________________________________________________________________________________________________________________________________
23  ___1___1___1___1________________________________________________________________________________________________________________________________________________
24  ___1___1___1___1________________________________________________________________________________________________________________________________________________
25  ___1___1___1___1________________________________________________________________________________________________________________________________________________
26  ___1___1___1___1________________________________________________________________________________________________________________________________________________
27  ___1___1___1___1________________________________________________________________________________________________________________________________________________
28  ___1___1___1___1________________________________________________________________________________________________________________________________________________
29  ___1___1___1___1________________________________________________________________________________________________________________________________________________
30  ___1___1___1___1________________________________________________________________________________________________________________________________________________
31  ___1___1___1___1________________________________________________________________________________________________________________________________________________
32  ___1___1___1___1________________________________________________________________________________________________________________________________________________
33  ___1___1___1___1________________________________________________________________________________________________________________________________________________
34  ___1___1___1___1________________________________________________________________________________________________________________________________________________
35  ___1___1___1___1________________________________________________________________________________________________________________________________________________
36  ___1___1___1___1________________________________________________________________________________________________________________________________________________
37  ___1___1___1___1________________________________________________________________________________________________________________________________________________
38  ___1___1___1___1________________________________________________________________________________________________________________________________________________
39  ___1___1___1___1________________________________________________________________________________________________________________________________________________
40  ___1___1___1___1________________________________________________________________________________________________________________________________________________
41  ___1___1___1___1________________________________________________________________________________________________________________________________________________
42  ___1___1___1___1________________________________________________________________________________________________________________________________________________
43  ___1___1___1___1________________________________________________________________________________________________________________________________________________
44  ___1___1___1___1________________________________________________________________________________________________________________________________________________
45  ___1___1___1___1________________________________________________________________________________________________________________________________________________
46  ___1___1___1___1________________________________________________________________________________________________________________________________________________
47  ___1___1___1___1________________________________________________________________________________________________________________________________________________
48  ___1___1___1___1________________________________________________________________________________________________________________________________________________
49  ___1___1___1___111111111________________________________________________________________________________________________________________________________________
50  ___1___1___1___1___1_1111111111_________________________________________________________________________________________________________________________________
51  ___1___1___1___1___1___1___1___111111___________________________________________________________________________________________________________________________
52  ___1___1___1___1___1___1___1___1___1_11_________________________________________________________________________________________________________________________
53  ___1___1___1___1___1___1___1___1___1___11_______________________________________________________________________________________________________________________
54  ___1___1___1___1___1___1___1___1___1___1_11_____________________________________________________________________________________________________________________
55  ___1___1___1___1___1___1___1___1___1___1___11___________________________________________________________________________________________________________________
56  ___1___1___1___1___1___1___1___1___1___1____1___________________________________________________________________________________________________________________
57  ___1___1___1___1___1___1___1___1___1___1____1___________________________________________________________________________________________________________________
58  ___1___1___1___1___1___1___1___1___1___1____1___________________________________________________________________________________________________________________
59  ___1___1___1___1___1___1___1___1___1___111111___________________________________________________________________________________________________________________
60  ___1___1___1___1___1___1___11111___11111________________________________________________________________________________________________________________________
61  ___1___1___1___1___1___1___111111111____________________________________________________________________________________________________________________________
62  ___1___1___1___1___1___1___1____________________________________________________________________________________________________________________________________
63  ___1___1___1___1___1___1___1____________________________________________________________________________________________________________________________________
64  ___1___1___1___1___1___1___1____________________________________________________________________________________________________________________________________
65  ___1___1___1___1___1___1__1_____________________________________________________________________________________________________________________________________
66  ___1___1___1___1___1___1__1_____________________________________________________________________________________________________________________________________
67  ___1___1___1___1___1___1__11____________________________________________________________________________________________________________________________________
68  ___1___1___1___1___1___1__11____________________________________________________________________________________________________________________________________
69  ___1___1___1___1___1___1__1_____________________________________________________________________________1111111111111111________________________________________
70  ___1___1___1___1___1___1__1___________________________________________________________________________11________________111_____________________________________
71  ___1___1___1___11111111111__________________________________________________________________________11_____________________11___________________________________
72  ___1___1___1_____133_____1__________________________________________________11111111111______________11__________________11_____________________________________
73  ___1___1___1_____1333____1_________________________________________________1__________1________________1_______________11_______________________________________
74  ___1___1___1____13333____1________________________________________________1___________1_________________111111111111111_________________________________________
75  ___1___1___1____13333____1________________________________________________1___________1_________________________________________________________________________
76  ___1___11111___133333____1_______________________________________________1____________1_________________________________________________________________________
77  ___1__________1333333____1________________________________________________1___________1_________________________________________________________________________
78  _3_1_________13333333____1_________________________________________________111111111111_________________________________________________________________________
79  _3_1_________13333333____1______________________________________________________________________________________________________________________________________
80  _331_____3__133333333____1______________________________________________________________________________________________________________________________________
81  _331____311133333333_____1_____________________________________________________111111111111111111_______________________________________________________________
82  _331_111133333333333_____1____________________________________________________1_________________1_______________________________________________________________
83  _33113333333333333333__331____________________________________________________11____________11111_______________________________________________________________
84  _33133333333333333333333_1______________________________________________________111____11111____________________________________________________________________
85  _33133333333333333333333_1_________________________________________________________1111_________________________________________________________________________
86  _33133333333333333333333_1______________________________________________________________________________________________________________________________________
87  _33133333333333333333333_1______________________________________________________________________________________________________________________________________
88  _33133333333333333333333_1______________________________________________________________________________________________________________________________________
89  _3313333333333333333333__1______________________________________________________________________________________________________________________________________
90  _3313333333333333333333__1______________________________________________________________________________________________________________________________________
91  _331333333333333333333___1______________________________________________________________________________________________________________________________________
92  _331333333333333333333___1________111111111111111_______________________________________________________________________________________________________________
93  _331333333333333333333___1_______1______________1_______________________________________________________________________________________________________________
94  _331333333333333333333___1______1_______________1_______________________________________________________________________________________________________________
95  _33133333333333333333____1_____1________________1_______________________________________________________________________________________________________________
96  _33133333333333333333____1111111___________111111_____________111111111111______________________________________________________________________________________
97  _33133333333333333333_____1________________1__________________1__________1______________________________________________________________________________________
98  _33133333333333333333_____1________________1__________________1___________1_____________________________________________________________________________________
99  _3313333333333333333_____1_______________11___________________1___________1_____________________________________________________________________________________
100 _3313333333333333333_____1_____________11_____________________1___________1_____________________________________________________________________________________
101 _3313333333333333333_____1___________11_____________3333______1__________1______________________________________________________________________________________
102 _3313333333333333333_____111111111111_____________333333333___13_________1___________________1111______________________11111____________________________________
103 _33133333333333333333____________________________33333333333_31_________1__________________1_11_1______________________1__111___________________________________
104 _33133333333333333333____________________________33333333333331_________1__________________111_1_______________________1__111___________________________________
105 _33133333333333333333___________________________333333333333331________1___________333___33111_1________________________1__113__________333333333_______________
106 _331333333333333333333_________333______________333333333333331________133_____333333333331_11_1________________________1__11333_______3333333333333____________
107 _33133333333333333333333___33333333___________33333333333333331_______13333333333333333333111__1________________________1__111333_____3333333333333333________3_
108 _33133333333333333333333333333333333________33333333333333333331_____133333333333333333333111_1_________________________1__11133333__33333333333333333333___333_
109 _331333333333333333333333333333333333333333333333333333333333331_____133333333333333333333111_1__________________________1__11333333333333333333333333333333333_
110 _331333333333333333333333333333333333333333333333333333333333331____1333333333333333333331_11_1__________________________1__11333333333333333333333333333333333_
111 _3313333333333333333333333333333333333333333333333333333333333331___133333333333333333333111_1___________________________1__11133333333333333333333333333333333_
112 _3313333333333333333333333333333333333333333333333333333333333331__1333333333333333333333111_1___________________________1__11133333333333333333333333333333333_
113 _3313333333333333333333333333333333333333333333333333333333333331_13333333333333333333331_11_1____________________________1__1133333333333333333333333333333333_
114 _331333333333333333333333333333333333333333333333333333333333333311333333333333333333333111__1____________________________1__1133333333333333333333333333333333_
115 _331333333333333333333333333333333333333333333333333333333333333313333333333333333333333111_1_____________________________1__1113333333333333333333333333333333_
116 _331333333333333333333333333333333333333333333333333333333333333333333333333333333333331_11_1_____________________________1__1113333333333333333333333333333333_
117 _33133333333333333333333333333333333333333333333333333333333333333333333333333333333333111__1______________________________1__113333333333333333333333333333333_
118 _33133333333333333333333333333333333333333333333333333333333333333333333333333333333333111_1_______________________________1__111333333333333333333333333333333_
119 _33133333333333333333333333333333333333333333333333333333333333333333333333333333333333111_1_______________________________1__111333333333333333333333333333333_
120 _33133333333333333333333333333333333333333333333333333333333333333333333333333333333331_11_1_______________________________1__111333333333333333333333333333333_
121 _3313333333333333333333333333333333333333333333333333333333333333333333333333333333333_11__11111111111111111111111111111111111111333333333333333333333333333333_
122 _3313333333333333333333333333333333333333333333333333333333333333333333333333333333333111_1____________________________________11133333333333333333333333333333_
123 _3313333333333333333333333333333333333333333333333333333333333333333333333333333333331_11_1_________________________________1__11133333333333333333333333333333_
124 _331333333333333333333333333333333333333333333333333333333333333333333333333333333333111__1_________________________________1__11133333333333333333333333333333_
125 _331333333333333333333333333333333333333333333333333333333333333333333333333333333333111_1___________________________________1__1133333333333333333333333333333_
126 _331333333333333333333333333333333333333333333333333333333333333333333333333333333331_11_1___________________________________1__1113333333333333333333333333333_
127 _33133333333333333333333333333333333333333333333333333333333333333333333333333333333111__1___________________________________1__1113333333333333333333333333333_
128 _33133333333333333333333333333333333333333333333333333333333333333333333333333333333111_1____________________________________1__1113333333333333333333333333333_
129 _33133333333333333333333333333333333333333333333333333333333333333333333333333333333111_1_____________________________________1__113333333333333333333333333333_
130 _33133333333333333333333333333333333333333333333333333333333333333333333333333333331_11_1_____________________________________1__111333333333333333333333333333_
131 _3313333333333333333333333333333333333333333333333333333333333333333333333333333333111__1_____________________________________1__111333333333333333333333333333_
132 _3313333333333333333333333333333333333333333333333333333333333333333333333333333333111_1______________________________________1__111333333333333333333333333333_
133 _3313333333333333333333333333333333333333333333333333333333333333333333333333333331_11_1_______________________________________1__11333333333333333333333333333_
134 _331333333333333333333333333333333333333333333333333333333333333333333333333333333111__1_______________________________________1__11133333333333333333333333333_
135 _331333333333333333333333333333333333333333333333333333333333333333333333333333333111_1________________________________________1__11133333333333333333333333333_
136 _331333333333333333333333333333333333333333333333333333333333333333333333333333331_11_1________________________________________1__11133333333333333333333333333_
137 _33133333333333333333333333333333333333333333333333333333333333333333333333333333111__1_________________________________________1__1113333333333333333333333333_
138 _33133333333333333333333333333333333333333333333333333333333333333333333333333333111__1_________________________________________1__1113333333333333333333333333_
139 _33133333333333333333333333333333333333333333333333333333333333333333333333333333111_1__________________________________________1__1113333333333333333333333333_
140 _33133333333333333333333333333333333333333333333333333333333333333333333333333331_11_1__________________________________________1__1113333333333333333333333333_
141 _3313333333333333333333333333333333333333333333333333333333333333333333333333333111__1___________________________________________1__111333333333333333333333333_
142 _3313333333333333333333333333333333333333333333333333333333333333333333333333333111_1____________________________________________1__111333333333333333333333333_
143 ___13333333333333333333333333333333333333333333333333333333333333333333333333331_11_1____________________________________________1__111333333333333333333333333_
144 ___1333333333333333333333333333333333333333333333333333333333333333_33333333333111__1____________________________________________1__111333333333333333333333333_
145 _3_133333333333333333333333333333333333333333333333333333333333333__33333333333111__1_____________________________________________1__11133333333333333333333333_
146 _3313333333333333333333333333333333333333333333333333333333333333_________33331_11_1______________________________________________1__11133333333333333333333333_
147 _331333333333333333333333333333333333333333333333333333333333333___________333111__1______________________________________________1__11133333333333333333333333_
148 _33133333333333333333333333333333333333333333333333333333333333_____________33111__1______________________________________________1__11133333333333333333333333_
149 _3313333333333333333333333333333333333333333333333333__33333_________________3111_1________________________________________________1__11_333333333__33333333333_
150 _33133333333333333333333333333333333333333333333333____33____________________1_11_1________________________________________________1__11__333333_______33333333_
151 _331333333333333333333333333333333333333333333333_____________________________11__1________________________________________________1__11____33__________________
152 _3313333333333333333333333333333333333333333333_______________________________11__1________________________________________________1__11________________________
153 _331333333333333333333333333333333333333333333________________________________11_1__________________________________________________1__11_______________________
154 _3313333333333333333333333333333333333333333_________________________________11__1__________________________________________________1__11_______________________
155 _331333333333333333333333333333333333333333__________________________________11________________________________________________________11_______________________
156 _331333333333333333333333333333333333333333_____________________________________________________________________________________________________________________
157 _33133333333333333333333333333333333333333______________________________________________________________________________________________________________________
158 _33133333333333333333333333333333333333333______________________________________________________________________________________________________________________
159 _33133333333333333333333333333333333333333______________________________________________________________________________________________________________________
160 _331333333333333333333333333333333333333________________________________________________________________________________________________________________________
161 _33133333333333333333333333333333333333_________________________________________________________________________________________________________________________
162 _331333333333333333333333333333333333___________________________________________________________________________________________________________________________
163 _33133333333333333333333333333333333____________________________________________________________________________________________________________________________
164 _331333333333333333333333333333333______________________________________________________________________________________________________________________________
165 _3313333333333333333333333333333________________________________________________________________________________________________________________________________
166 _331333333333333333333333333333_________________________________________________________________________________________________________________________________
167 ________________________________________________________________________________________________________________________________________________________________
