    0         10        20        30        40        50        60        70        80        90        100       110       120       130       140       150       
    0123456789012345678901234567890123456789012345678901234567890123456789012345678901234567890123456789012345678901234567890123456789012345678901234567890123456789
0   ________________1___________1_______1__________1________________________________________________________________________________________________________________
1   ________________11__________1_______1__________1________________________________________________________________________________________________________________
2   _________________11_________1_______1__________1________________________________________________________________________________________________________________
3   __________________11________1_______1__________1________________________________________________________________________________________________________________
4   2__________________11_______1_______1__________1________________________________________________________________________________________________________________
5   12__________________11______1_______1__________1________________________________________________________________________________________________________________
6   _12__________________11_____1_______1__________1________________________________________________________________________________________________________________
7   __12__________________11____1_______1__________1________________________________________________________________________________________________________________
8   ___12__________________11___1_______1__________1________________________________________________________________________________________________________________
9   ____12__________________11__1_______1__________1___________1____________________________________________________________________________________________________
10  _____12__________________11_1_______1__________1___________1____________________________________________________________________________________________________
11  ______12__________________111_______1__________1___________1____________________________________________________________________________________________________
12  _______12__________________11_______1__________1___________1____________________________________________________________________________________________________
13  ________12__________________11______1__________1___________1____________________________________________________________________________________________________
14  _________12__________________11_____1__________1___________1____________________________________________________________________________________________________
15  __________12__________________11____1__________1___________1____________________________________________________________________________________________________
16  ___________12__________________11___1__________1___________1____________________________________________________________________________________________________
17  ____________12__________________11__1__________1___________1____________________________________________________________________________________________________
18  _____________12__________________11_1__________1___________1____________________________________________________________________________________________________
19  ______________12__________________111__________1___________1_________1__________________________________________________________________________________________
20  _______________12__________________11__________1___________1_________1__________________________________________________________________________________________
21  ________________12__________________11_________1___________1_________1__________________________________________________________________________________________
22  _________________12__________________11________1___________1_________1__________________________________________________________________________________________
23  __________________12__________________11_______1___________1_________1__________________________________________________________________________________________
24  ___________________12__________________11______1___________1_________1__________1_______________________________________________________________________________
25  ____________________12__________________11_____1___________1_________1__________1_______________________________________________________________________________
26  _____________________12__________________11____1___________1_________1__________1_______________________________________________________________________________
27  ______________________12__________________11___1___________1_________1__________1_______________________________________________________________________________
28  _______________________12__________________11__1___________1_________1__________1_______________________________________________________________________________
29  ________________________12_________________111_1___________1_________1__________1_______________________________________________________________________________
30  _________________________12_________________1111___________1_________1__________1_______________________________________________________________________________
31  __________________________12_________________111___________1_________1__________1_______________________________________________________________________________
32  ___________________________12_________________111__________1_________1__________1_______________________________________________________________________________
33  ____________________________12_________________111_________1_________1__________1_______________________________________________________________________________
34  _____________________________12_________________111________1_________1__________1_______________________________________________________________________________
35  ______________________________12_________________111_______1_________1__________1__________1____________________________________________________________________
36  _______________________________12_________________111______1_________1__________1__________1____________________________________________________________________
37  ________________________________12_________________111_____1_________1__________1__________1____________________________________________________________________
38  _________________________________12_________________111____1_________1__________1__________1____________________________________________________________________
39  __________________________________12_1_______________111___1_________1__________1__________1____________________________________________________________________
40  ___________________________________12_11______________111__1_________1__________1__________1____________________________________________________________________
41  ____________________________________12__11_____________111_1_________1__________1__________1____________________________________________________________________
42  _____________________________________12___1_____________1111_________1__________1__________1__________1_________________________________________________________
43  ______________________________________12_________________111_________1__________1__________1__________1_________________________________________________________
44  _______________________________________12_________________111________1__________1__________1__________1_________________________________________________________
45  ________________________________________12_________________111_______1__________1__________1__________1_________________________________________________________
46  _________________________________________12_________________111______1__________1__________1__________1_________________________________________________________
47  __________________________________________12_________________111_____1__________1__________1__________1_________________________________________________________
48  ___________________________________________12_________________111____1__________1__________1__________1_________________________________________________________
49  ____________________________________________12_________________111___1__________1__________1__________1_________________________________________________________
50  _____________________________________________12_________________111__1__________1__________1__________1___________________1_________1___________1_______________
51  ______________________________________________12_________________111_1__________1__________1__________1________1__________1_________1___________1_______________
52  _______________________________________________12_________________1111__________1__________1__________1________1__________1_________1___________1_______________
53  ________________________________________________12_________________111__________1__________1__________1________1__________1_________1___________1_______________
54  _________________________________________________12_________________111_________1__________1__________1________1__________1_________1___________1_______________
55  __________________________________________________12_________________111________1__________1__________1________1__________1_________1___________1_______________
56  ___________________________________________________12_________________111_______1__________1__________1________1__________1_________1___________1_______________
57  ____________________________________________________12_________________111______1__________1__________1________1__________1_________1___________1_______________
58  _____________________________________________________12_________________111_____1__________1__________1________1__________1_________1___________1_______________
59  ______________________________________________________12_________________111____1__________1__________1________1__________1_________1___________1_______________
60  _______________________________________________________12_________________111___1__________1__________1________1__________1_________1___________1_______________
61  ________________________________________________________12_________________111__1__________1__________1________1__________1_________1___________1_______________
62  _________________________________________________________12_________________111_1__________1__________1________1__________1_________1___________1_______________
63  __________________________________________________________12_________________1111__________1__________1________1__________1_________1___________1_______________
64  ___________________________________________________________12_________________111__________1__________1________1__________1_________1___________1_______________
65  ____________________________________________________________12_________________111_________1__________1________1__________1_________1___________1_______________
66  _____________________________________________________________12_________________111________1__________1________1__________1_________1___________1_______________
67  ______________________________________________________________12_________________111_______1__________1________1__________1_________1___________1_______________
68  _______________________________________________________________12_________________111______1__________1________1__________1_________1___________1_______________
69  ________________________________________________________________12_________________111_____1__________1________1__________1_________1___________1_______________
70  _________________________________________________________________12_________________111____1__________1________1__________1_________1___________1_______________
71  __________________________________________________________________12_________________111___1__________1________1__________1_________1___________1_______________
72  ___________________________________________________________________12_________________111__1__________1________1__________1_________1___________1_______________
73  ____________________________________________________________________12_________________111_1__________1________1__________1_________1___________1_______________
74  _____________________________________________________________________12_________________1111__________1________1__________1_________1___________1_______________
75  ______________________________________________________________________12_1_______________111__________1________1__________1_________1___________1_______________
76  _______________________________________________________________________12_1_______________111_________1________1__________1_________1___________1_______________
77  ________________________________________________________________________12_1_______________111________1________1__________1_________1___________1_______________
78  _________________________________________________________________________12_1_______________111_______1________1__________1_________1___________1_______________
79  __________________________________________________________________________12_1_______________111______1________1__________1_________1___________1_______________
80  ___________________________________________________________________________12_1_______________111_____1________1__________1_________1___________1_______________
81  ____________________________________________________________________________12_________________111____1________1__________1_________1___________1_______________
82  _____________________________________________________________________________12_________________111___1________1__________1_________1___________1_______________
83  ______________________________________________________________________________12_________________111__1________1__________1_________1___________1_______________
84  _______________________________________________________________________________12_________________111_1________1__________1_________1___________1_______________
85  ________________________________________________________________________________12________________11111________1__________1_________1___________1_______________
86  _________________________________________________________________________________12________________1111________1__________1_________1___________1_______________
87  __________________________________________________________________________________12________________1111_______1__________1_________1___________1_______________
88  ___________________________________________________________________________________12________________1111______1__________1_________1___________1_______________
89  ____________________________________________________________________________________12________________1111_____1__________1_________1___________1_______________
90  _____________________________________________________________________________________12________________1111____1__________1_________1___________1_______________
91  ______________________________________________________________________________________12__1_____________1111___1__________1_________1___________1_______________
92  _______________________________________________________________________________________12__1_____________1111__1__________1_________1___________1_______________
93  ________________________________________________________________________________________12__1_____________1111_1__________1_________1___________1_______________
94  _________________________________________________________________________________________12__1_____________11111__________1_________1___________1_______________
95  __________________________________________________________________________________________12_1______________1111__________1_________1___________1_______________
96  ___________________________________________________________________________________________12_1______________1111_________1_________1___________1_______________
97  ____________________________________________________________________________________________12_1______________1111________1_________1___________1_______________
98  _____________________________________________________________________________________________12_1______________1111_______1_________1___________1_______________
99  ______________________________________________________________________________________________12________________1111______1_________1___________1_______________
100 _______________________________________________________________________________________________12________________1111_____1_________1___________1_______________
101 ________________________________________________________________________________________________12________________1111____1_________1___________1_______________
102 _________________________________________________________________________________________________12________________1111___1_________1___________1_______________
103 __________________________________________________________________________________________________12________________1111__1_________1___________1_______________
104 ___________________________________________________________________________________________________12________________1111_1_________1___________1_______________
105 ____________________________________________________________________________________________________12________________11111_________1___________1_______________
106 _____________________________________________________________________________________________________12________________11111________1___________1_______________
107 ______________________________________________________________________________________________________12________________111111______1___________1_______________
108 _______________________________________________________________________________________________________12________________1111_111___1___________1_______________
109 ________________________________________________________________________________________________________12________________1111___11_1___________1_______________
110 _________________________________________________________________________________________________________12________________11111111111111111111111______________
111 __________________________________________________________________________________________________________12________________1111111111111111111111______________
112 ___________________________________________________________________________________________________________12________________1__111_____________1_______________
113 ____________________________________________________________________________________________________________12________________11_________________11_____________
114 _____________________________________________________________________________________________________________12______________1_____________________1____________
115 ______________________________________________________________________________________________________________12____________________________________1___________
116 _______________________________________________________________________________________________________________12____________________________________1__________
117 ________________________________________________________________________________________________________________12____________________________________1_________
118 _________________________________________________________________________________________________________________12____________________________________11_______
119 __________________________________________________________________________________________________________________12___1_________________________________1______
120 ___________________________________________________________________________________________________________________12___1________________________________1______
121 ____________________________________________________________________________________________________________________12___1______________________________1_______
122 _____________________________________________________________________________________________________________________12__1______________________________1_______
123 ______________________________________________________________________________________________________________________12__1_____________________________1_______
124 _______________________________________________________________________________________________________________________12__1_____________________________1______
125 ________________________________________________________________________________________________________________________1___1_____________________________11____
126 _________________________________________________________________________________________________________________________1_11_______________________________1_1_
127 __________________________________________________________________________________________________________________________1_1_________________________________1_
128 _________________________________________________________________________________________________________________________1__1_________________________________1_
129 ________________________________________________________________________________________________________________________1___1_________________________________1_
130 _______________________________________________________________________________________________________________________1____1_________________________________1_
131 ______________________________________________________________________________________________________________________1111111_________________________________1_
132 _____________________________________________________________________________________________________________________1________________________________________1_
133 ____________________________________________________________________________________________________________________1________________2________________________1_
134 ___________________________________________________________________________________________________________________1________________211_______________________1_
135 __________________________________________________________________________________________________________________1________________211_1______________________1_
136 _________________________________________________________________________________________________________________1________________211_1_11____________________1_
137 ________________________________________________________________________________________________________________1________________211___1__1___________________1_
138 _______________________________________________________________________________________________________________1________________211_____11_1__________________1_
139 ______________________________________________________________________________________________________________1________________211_______11_1111111111111111111_
140 _____________________________________________________________________________________________________________1________________211________1_11111111111111111111_
141 ____________________________________________________________________________________________________________1________________2111________1_________1____________
142 ___________________________________________________________________________________________________________1________________211_1________1_________1____________
143 ________________________________________________________________________________________________________111________________211__1________1_________1____________
144 _______________________________________________________________________________________________________1_1________________211___1________1_________1____________
145 ______________________________________________________________________________________________________111________________211____1________1_________1____________
146 _____________________________________________________________________________________________________11_________________211_____1________1_________1____________
147 ____________________________________________________________________________________________________11_________________211______1________1_________1____________
148 ___________________________________________________________________________________________________11_________________2111______1________1_________1____________
149 __________________________________________________________________________________________________11_________________211_1______1________1_________1____________
150 _________________________________________________________________________________________________11_________________211__1______1________1_________1____________
151 ________________________________________________________________________________________________11_________________211___1______1________1_________1____________
152 _______________________________________________________________________________________________11_________________211____1______1________1_________1____________
153 ______________________________________________________________________________________________11_________________211_____1______1________1_________1____________
154 _____________________________________________________________________________________________11_________________211______1______1________1_________1____________
155 ____________________________________________________________________________________________11_________________211_______1______1________1_________1____________
156 ___________________________________________________________________________________________11_________________2111_______1______1________1_________1____________
157 __________________________________________________________________________________________11_________________211_1_______1______1________1_________1____________
158 _________________________________________________________________________________________11_________________211__1_______1______1________1_________1____________
159 ________________________________________________________________________________________11_________________211___1_______1______1________1_________1____________
160 _______________________________________________________________________________________11_________________211____1_______1______1________1_________1____________
161 ______________________________________________________________________________________11_________________211_____1_______1______1________1_________1____________
162 _____________________________________________________________________________________11_________________211______1_______1______1________1_________1____________
163 ____________________________________________________________________________________11_________________211_______1_______1______1________1_________1____________
164 ___________________________________________________________________________________11_________________2111_______1_______1______1________1_________1____________
165 __________________________________________________________________________________11_________________211_1_______1_______1______1________1_________1____________
166 _________________________________________________________________________________11_________________211__1_______1_______1______1________1_________1____________
167 ________________________________________________________________________________11_________________211__________________________________________________________
